,Codice comune,Denominazione,Totale Maschi,Totale Femmine,Totale Abitanti
101,1001,Agliè,1237,1398,2635
203,1002,Airasca,1873,1808,3681
305,1003,Ala di Stura,238,215,453
407,1004,Albiano d'Ivrea,808,838,1646
509,1006,Almese,3121,3257,6378
611,1007,Alpette,128,114,242
713,1008,Alpignano,8065,8314,16379
815,1009,Andezeno,997,1016,2013
917,1010,Andrate,267,232,499
1019,1011,Angrogna,435,428,863
1121,1012,Arignano,568,507,1075
1223,1013,Avigliana,6130,6433,12563
1325,1014,Azeglio,619,639,1258
1427,1015,Bairo,379,421,800
1529,1016,Balangero,1531,1632,3163
1631,1017,Baldissero Canavese,262,280,542
1733,1018,Baldissero Torinese,1821,1859,3680
1835,1019,Balme,61,50,111
1937,1020,Banchette,1509,1730,3239
2039,1021,Barbania,792,812,1604
2141,1022,Bardonecchia,1563,1586,3149
2243,1023,Barone Canavese,297,292,589
2345,1024,Beinasco,8648,9288,17936
2447,1025,Bibiana,1729,1734,3463
2549,1026,Bobbio Pellice,261,284,545
2651,1027,Bollengo,1097,1070,2167
2753,1028,Borgaro Torinese,5808,6104,11912
2855,1029,Borgiallo,295,293,588
2957,1030,Borgofranco d'Ivrea,1758,1914,3672
3059,1031,Borgomasino,374,414,788
3161,1032,Borgone Susa,1111,1098,2209
3263,1033,Bosconero,1555,1578,3133
3365,1034,Brandizzo,4292,4446,8738
3467,1035,Bricherasio,2269,2347,4616
3569,1036,Brosso,192,202,394
3671,1037,Brozolo,226,210,436
3773,1038,Bruino,4312,4384,8696
3875,1039,Brusasco,765,763,1528
3977,1040,Bruzolo,761,765,1526
4079,1041,Buriasco,670,681,1351
4181,1042,Burolo,544,600,1144
4283,1043,Busano,846,790,1636
4385,1044,Bussoleno,2832,3109,5941
4487,1045,Buttigliera Alta,3125,3282,6407
4589,1046,Cafasse,1681,1735,3416
4691,1047,Caluso,3636,3908,7544
4793,1048,Cambiano,2895,3085,5980
4895,1049,Campiglione Fenile,663,678,1341
4997,1050,Candia Canavese,598,634,1232
5099,1051,Candiolo,2785,2850,5635
5201,1052,Canischio,143,134,277
5303,1053,Cantalupa,1278,1342,2620
5405,1054,Cantoira,304,272,576
5507,1055,Caprie,1043,1042,2085
5609,1056,Caravino,437,465,902
5711,1057,Carema,366,405,771
5813,1058,Carignano,4544,4730,9274
5915,1059,Carmagnola,14135,14834,28969
6017,1060,Casalborgone,927,960,1887
6119,1061,Cascinette d'Ivrea,753,758,1511
6221,1062,Caselette,1506,1524,3030
6323,1063,Caselle Torinese,6832,7126,13958
6425,1064,Castagneto Po,896,886,1782
6527,1065,Castagnole Piemonte,1106,1138,2244
6629,1066,Castellamonte,4885,5061,9946
6731,1067,Castelnuovo Nigra,220,210,430
6833,1068,Castiglione Torinese,3210,3291,6501
6935,1069,Cavagnolo,1006,1053,2059
7037,1070,Cavour,2715,2777,5492
7139,1071,Cercenasco,879,930,1809
7241,1072,Ceres,543,502,1045
7343,1073,Ceresole Reale,90,77,167
7445,1074,Cesana Torinese,507,436,943
7547,1075,Chialamberto,181,187,368
7649,1076,Chianocco,796,816,1612
7751,1077,Chiaverano,984,1074,2058
7853,1078,Chieri,17727,19231,36958
7955,1079,Chiesanuova,123,110,233
8057,1080,Chiomonte,442,445,887
8159,1081,Chiusa di San Michele,819,803,1622
8261,1082,Chivasso,12987,13922,26909
8363,1083,Ciconio,194,194,388
8465,1084,Cintano,127,125,252
8567,1085,Cinzano,166,164,330
8669,1086,Ciriè,8879,9697,18576
8771,1087,Claviere,107,103,210
8873,1088,Coassolo Torinese,763,734,1497
8975,1089,Coazze,1649,1587,3236
9077,1090,Collegno,23785,25901,49686
9179,1091,Colleretto Castelnuovo,154,162,316
9281,1092,Colleretto Giacosa,293,280,573
9383,1093,Condove,2247,2349,4596
9485,1094,Corio,1581,1628,3209
9587,1095,Cossano Canavese,246,240,486
9689,1096,Cuceglio,492,497,989
9791,1097,Cumiana,3938,3957,7895
9893,1098,Cuorgnè,4715,4962,9677
9995,1099,Druento,4342,4521,8863
10097,1100,Exilles,129,122,251
10199,1101,Favria,2604,2643,5247
10301,1102,Feletto,1115,1150,2265
10403,1103,Fenestrelle,261,249,510
10505,1104,Fiano,1306,1361,2667
10607,1105,Fiorano Canavese,379,390,769
10709,1106,Foglizzo,1121,1198,2319
10811,1107,Forno Canavese,1676,1660,3336
10913,1108,Frassinetto,154,126,280
11015,1109,Front,818,823,1641
11117,1110,Frossasco,1394,1472,2866
11219,1111,Garzigliana,276,276,552
11321,1112,Gassino Torinese,4572,4987,9559
11423,1113,Germagnano,586,580,1166
11525,1114,Giaglione,287,322,609
11627,1115,Giaveno,7988,8398,16386
11729,1116,Givoletto,1993,1946,3939
11831,1117,Gravere,339,337,676
11933,1118,Groscavallo,99,100,199
12035,1119,Grosso,497,528,1025
12137,1120,Grugliasco,18007,19585,37592
12239,1121,Ingria,25,19,44
12341,1122,Inverso Pinasca,355,347,702
12443,1123,Isolabella,192,191,383
12545,1124,Issiglio,195,192,387
12647,1125,Ivrea,11117,12325,23442
12749,1126,La Cassa,911,892,1803
12851,1127,La Loggia,4388,4458,8846
12953,1128,Lanzo Torinese,2442,2573,5015
13055,1129,Lauriano,713,723,1436
13157,1130,Leini,8141,8315,16456
13259,1131,Lemie,107,100,207
13361,1132,Lessolo,885,935,1820
13463,1133,Levone,217,225,442
13565,1134,Locana,691,747,1438
13667,1135,Lombardore,872,863,1735
13769,1136,Lombriasco,553,492,1045
13871,1137,Loranzè,574,592,1166
13973,1139,Luserna San Giovanni,3475,3773,7248
14075,1140,Lusernetta,253,243,496
14177,1141,Lusigliè,282,287,569
14279,1142,Macello,589,580,1169
14381,1143,Maglione,200,217,417
14483,1144,Marentino,671,635,1306
14585,1145,Massello,29,25,54
14687,1146,Mathi,1907,1939,3846
14789,1147,Mattie,333,336,669
14891,1148,Mazzè,2028,2114,4142
14993,1149,Meana di Susa,400,388,788
15095,1150,Mercenasco,637,594,1231
15197,1152,Mezzenile,402,395,797
15299,1153,Mombello di Torino,196,194,390
15401,1154,Mompantero,302,347,649
15503,1155,Monastero di Lanzo,186,160,346
15605,1156,Moncalieri,27840,29687,57527
15707,1157,Moncenisio,19,16,35
15809,1158,Montaldo Torinese,355,365,720
15911,1159,Montalenghe,463,533,996
16013,1160,Montalto Dora,1678,1723,3401
16115,1161,Montanaro,2553,2627,5180
16217,1162,Monteu da Po,431,423,854
16319,1163,Moriondo Torinese,424,419,843
16421,1164,Nichelino,22958,24536,47494
16523,1165,Noasca,57,59,116
16625,1166,Nole,3310,3507,6817
16727,1167,Nomaglio,143,143,286
16829,1168,None,3985,4037,8022
16931,1169,Novalesa,275,263,538
17033,1170,Oglianico,743,746,1489
17135,1171,Orbassano,11315,12037,23352
17237,1172,Orio Canavese,388,386,774
17339,1173,Osasco,564,589,1153
17441,1174,Osasio,482,435,917
17543,1175,Oulx,1707,1664,3371
17645,1176,Ozegna,607,620,1227
17747,1177,Palazzo Canavese,409,428,837
17849,1178,Pancalieri,1021,1070,2091
17951,1179,Parella,199,231,430
18053,1180,Pavarolo,557,578,1135
18155,1181,Pavone Canavese,1862,1986,3848
18257,1183,Pecetto Torinese,1995,2050,4045
18359,1184,Perosa Argentina,1514,1657,3171
18461,1185,Perosa Canavese,257,263,520
18563,1186,Perrero,349,296,645
18665,1187,Pertusio,374,384,758
18767,1188,Pessinetto,328,289,617
18869,1189,Pianezza,7506,7885,15391
18971,1190,Pinasca,1411,1526,2937
19073,1191,Pinerolo,17177,18942,36119
19175,1192,Pino Torinese,4013,4389,8402
19277,1193,Piobesi Torinese,1855,1951,3806
19379,1194,Piossasco,9000,9366,18366
19481,1195,Piscina,1643,1727,3370
19583,1196,Piverone,654,711,1365
19685,1197,Poirino,5224,5188,10412
19787,1198,Pomaretto,481,530,1011
19889,1199,Pont-Canavese,1573,1717,3290
19991,1200,Porte,524,510,1034
20093,1201,Pragelato,414,361,775
20195,1202,Prali,128,111,239
20297,1203,Pralormo,940,965,1905
20399,1204,Pramollo,117,107,224
20501,1205,Prarostino,641,642,1283
20603,1206,Prascorsano,376,377,753
20705,1207,Pratiglione,256,258,514
20807,1208,Quagliuzzo,172,159,331
20909,1209,Quassolo,162,183,345
21011,1210,Quincinetto,503,527,1030
21113,1211,Reano,861,913,1774
21215,1212,Ribordone,26,23,49
21317,1213,Rivalba,589,564,1153
21419,1214,Rivalta di Torino,9914,10154,20068
21521,1215,Riva presso Chieri,2351,2398,4749
21623,1216,Rivara,1288,1298,2586
21725,1217,Rivarolo Canavese,5966,6496,12462
21827,1218,Rivarossa,805,787,1592
21929,1219,Rivoli,23254,25288,48542
22031,1220,Robassomero,1477,1589,3066
22133,1221,Rocca Canavese,882,832,1714
22235,1222,Roletto,1025,1009,2034
22337,1223,Romano Canavese,1295,1356,2651
22439,1224,Ronco Canavese,155,145,300
22541,1225,Rondissone,976,911,1887
22643,1226,Rorà,127,110,237
22745,1227,Roure,391,406,797
22847,1228,Rosta,2427,2530,4957
22949,1229,Rubiana,1185,1188,2373
23051,1230,Rueglio,381,396,777
23153,1231,Salassa,915,935,1850
23255,1232,Salbertrand,310,307,617
23357,1233,Salerano Canavese,228,245,473
23459,1234,Salza di Pinerolo,47,30,77
23561,1235,Samone,774,807,1581
23663,1236,San Benigno Canavese,2955,3075,6030
23765,1237,San Carlo Canavese,1959,2065,4024
23867,1238,San Colombano Belmonte,180,174,354
23969,1239,San Didero,270,270,540
24071,1240,San Francesco al Campo,2424,2484,4908
24173,1241,Sangano,1786,1966,3752
24275,1242,San Germano Chisone,885,876,1761
24377,1243,San Gillio,1555,1638,3193
24479,1244,San Giorgio Canavese,1253,1314,2567
24581,1245,San Giorio di Susa,467,500,967
24683,1246,San Giusto Canavese,1621,1734,3355
24785,1247,San Martino Canavese,403,414,817
24887,1248,San Maurizio Canavese,5071,5243,10314
24989,1249,San Mauro Torinese,9113,9797,18910
25091,1250,San Pietro Val Lemina,694,722,1416
25193,1251,San Ponso,129,124,253
25295,1252,San Raffaele Cimena,1523,1594,3117
25397,1253,San Sebastiano da Po,964,972,1936
25499,1254,San Secondo di Pinerolo,1793,1824,3617
25601,1255,Sant'Ambrogio di Torino,2367,2340,4707
25703,1256,Sant'Antonino di Susa,2018,2230,4248
25805,1257,Santena,5277,5462,10739
25907,1258,Sauze di Cesana,132,115,247
26009,1259,Sauze d'Oulx,570,526,1096
26111,1260,Scalenghe,1657,1625,3282
26213,1261,Scarmagno,395,435,830
26315,1262,Sciolze,713,735,1448
26417,1263,Sestriere,497,438,935
26519,1264,Settimo Rottaro,224,248,472
26621,1265,Settimo Torinese,22790,24209,46999
26723,1266,Settimo Vittone,778,754,1532
26825,1267,Sparone,472,498,970
26927,1268,Strambinello,125,145,270
27029,1269,Strambino,3053,3237,6290
27131,1270,Susa,2993,3263,6256
27233,1271,Tavagnasco,384,411,795
27335,1272,Torino,417763,457935,875698
27437,1273,Torrazza Piemonte,1453,1504,2957
27539,1274,Torre Canavese,284,317,601
27641,1275,Torre Pellice,2204,2383,4587
27743,1276,Trana,1899,1926,3825
27845,1278,Traversella,160,164,324
27947,1279,Traves,268,258,526
28049,1280,Trofarello,5232,5626,10858
28151,1281,Usseaux,91,95,186
28253,1282,Usseglio,102,99,201
28355,1283,Vaie,708,704,1412
28457,1284,Val della Torre,1989,1932,3921
28559,1285,Valgioie,517,440,957
28661,1286,Vallo Torinese,399,376,775
28763,1287,Valperga,1462,1594,3056
28865,1288,Valprato Soana,50,49,99
28967,1289,Varisella,412,418,830
29069,1290,Vauda Canavese,726,721,1447
29171,1291,Venaus,434,448,882
29273,1292,Venaria Reale,16260,17304,33564
29375,1293,Verolengo,2375,2466,4841
29477,1294,Verrua Savoia,692,706,1398
29579,1295,Vestignè,394,402,796
29681,1296,Vialfrè,120,122,242
29783,1298,Vidracco,253,275,528
29885,1299,Vigone,2553,2610,5163
29987,1300,Villafranca Piemonte,2265,2351,4616
30089,1301,Villanova Canavese,585,627,1212
30191,1302,Villarbasse,1677,1778,3455
30293,1303,Villar Dora,1435,1457,2892
30395,1304,Villareggia,518,537,1055
30497,1305,Villar Focchiardo,979,988,1967
30599,1306,Villar Pellice,531,538,1069
30701,1307,Villar Perosa,1952,2096,4048
30803,1308,Villastellone,2292,2367,4659
30905,1309,Vinovo,7424,7720,15144
31007,1310,Virle Piemonte,583,590,1173
31109,1311,Vische,624,644,1268
31211,1312,Vistrorio,256,275,531
31313,1313,Viù,516,500,1016
31415,1314,Volpiano,7556,7894,15450
31517,1315,Volvera,4271,4368,8639
31619,1316,Mappano,3667,3672,7339
31721,1317,Val di Chy,641,641,1282
31823,1318,Valchiusa,501,531,1032
31925,2002,Alagna Valsesia,370,338,708
32027,2003,Albano Vercellese,164,157,321
32129,2004,Alice Castello,1306,1274,2580
32231,2006,Arborio,446,416,862
32333,2007,Asigliano Vercellese,696,746,1442
32435,2008,Balmuccia,47,65,112
32537,2009,Balocco,127,100,227
32639,2011,Bianzè,929,987,1916
32741,2014,Boccioleto,85,93,178
32843,2015,Borgo d'Ale,1182,1159,2341
32945,2016,Borgosesia,5943,6628,12571
33047,2017,Borgo Vercelli,1092,1158,2250
33149,2021,Buronzo,420,443,863
33251,2025,Campertogno,125,110,235
33353,2029,Carcoforo,43,33,76
33455,2030,Caresana,554,505,1059
33557,2031,Caresanablot,545,578,1123
33659,2032,Carisio,413,393,806
33761,2033,Casanova Elvo,124,99,223
33863,2035,San Giacomo Vercellese,144,150,294
33965,2041,Cervatto,37,21,58
34067,2042,Cigliano,2122,2304,4426
34169,2043,Civiasco,131,123,254
34271,2045,Collobiano,42,46,88
34373,2047,Costanzana,373,384,757
34475,2048,Cravagliana,133,117,250
34577,2049,Crescentino,3859,3927,7786
34679,2052,Crova,193,218,411
34781,2054,Desana,506,558,1064
34883,2057,Fobello,110,82,192
34985,2058,Fontanetto Po,552,551,1103
35087,2059,Formigliana,254,250,504
35189,2061,Gattinara,3791,4034,7825
35291,2062,Ghislarengo,423,434,857
35393,2065,Greggio,178,171,349
35495,2066,Guardabosone,171,167,338
35597,2067,Lamporo,256,252,508
35699,2068,Lenta,401,432,833
35801,2070,Lignana,260,297,557
35903,2071,Livorno Ferraris,2086,2248,4334
36005,2072,Lozzolo,397,427,824
36107,2078,Mollia,56,42,98
36209,2079,Moncrivello,697,698,1395
36311,2082,Motta de' Conti,386,377,763
36413,2088,Olcenengo,380,402,782
36515,2089,Oldenico,110,109,219
36617,2090,Palazzolo Vercellese,579,608,1187
36719,2091,Pertengo,145,151,296
36821,2093,Pezzana,632,660,1292
36923,2096,Pila,78,60,138
37025,2097,Piode,86,94,180
37127,2102,Postua,292,286,578
37229,2104,Prarolo,355,371,726
37331,2107,Quarona,1890,2111,4001
37433,2108,Quinto Vercellese,198,201,399
37535,2110,Rassa,37,27,64
37637,2113,Rimella,83,52,135
37739,2115,Rive,217,230,447
37841,2116,Roasio,1137,1199,2336
37943,2118,Ronsecco,271,296,567
38045,2121,Rossa,100,78,178
38147,2122,Rovasenda,446,483,929
38249,2126,Salasco,116,109,225
38351,2127,Sali Vercellese,51,54,105
38453,2128,Saluggia,1920,1996,3916
38555,2131,San Germano Vercellese,751,793,1544
38657,2133,Santhià,4090,4378,8468
38759,2134,Scopa,196,195,391
38861,2135,Scopello,186,176,362
38963,2137,Serravalle Sesia,2378,2513,4891
39065,2142,Stroppiana,579,615,1194
39167,2147,Tricerro,354,340,694
39269,2148,Trino,3444,3585,7029
39371,2150,Tronzano Vercellese,1685,1769,3454
39473,2152,Valduggia,975,984,1959
39575,2156,Varallo,3393,3746,7139
39677,2158,Vercelli,21858,24177,46035
39779,2163,Villarboit,211,216,427
39881,2164,Villata,791,773,1564
39983,2166,Vocca,84,77,161
40085,2170,Alto Sermenza,88,69,157
40187,2171,Cellio con Breia,493,488,981
40289,3001,Agrate Conturbia,785,764,1549
40391,3002,Ameno,516,437,953
40493,3006,Armeno,1059,1137,2196
40595,3008,Arona,6511,7441,13952
40697,3012,Barengo,381,407,788
40799,3016,Bellinzago Novarese,4803,4776,9579
40901,3018,Biandrate,661,641,1302
41003,3019,Boca,591,607,1198
41105,3021,Bogogno,632,644,1276
41207,3022,Bolzano Novarese,608,589,1197
41309,3023,Borgolavezzaro,976,1054,2030
41411,3024,Borgomanero,10408,11258,21666
41513,3025,Borgo Ticino,2588,2578,5166
41615,3026,Briga Novarese,1383,1451,2834
41717,3027,Briona,555,597,1152
41819,3030,Caltignaga,1233,1284,2517
41921,3032,Cameri,5292,5564,10856
42023,3036,Carpignano Sesia,1182,1336,2518
42125,3037,Casalbeltrame,481,457,938
42227,3039,Casaleggio Novara,457,458,915
42329,3040,Casalino,772,753,1525
42431,3041,Casalvolone,422,442,864
42533,3042,Castellazzo Novarese,152,167,319
42635,3043,Castelletto sopra Ticino,4765,5150,9915
42737,3044,Cavaglietto,199,184,383
42839,3045,Cavaglio d'Agogna,579,593,1172
42941,3047,Cavallirio,673,670,1343
43043,3049,Cerano,3314,3450,6764
43145,3051,Colazza,218,233,451
43247,3052,Comignago,632,627,1259
43349,3055,Cressa,779,826,1605
43451,3058,Cureggio,1267,1369,2636
43553,3060,Divignano,690,724,1414
43655,3062,Dormelletto,1219,1366,2585
43757,3065,Fara Novarese,996,1041,2037
43859,3066,Fontaneto d'Agogna,1288,1363,2651
43961,3068,Galliate,7618,8101,15719
44063,3069,Garbagna Novarese,700,733,1433
44165,3070,Gargallo,868,899,1767
44267,3073,Ghemme,1711,1788,3499
44369,3076,Gozzano,2779,2782,5561
44471,3077,Granozzo con Monticello,689,692,1381
44573,3079,Grignasco,2165,2313,4478
44675,3082,Invorio,2171,2223,4394
44777,3083,Landiona,271,292,563
44879,3084,Lesa,1049,1162,2211
44981,3088,Maggiora,799,859,1658
45083,3090,Mandello Vitta,108,120,228
45185,3091,Marano Ticino,835,816,1651
45287,3093,Massino Visconti,519,531,1050
45389,3095,Meina,1137,1285,2422
45491,3097,Mezzomerico,622,607,1229
45593,3098,Miasino,354,440,794
45695,3100,Momo,1181,1313,2494
45797,3103,Nebbiuno,912,897,1809
45899,3104,Nibbiola,409,418,827
46001,3106,Novara,50414,53865,104279
46103,3108,Oleggio,6927,7229,14156
46205,3109,Oleggio Castello,1086,1091,2177
46307,3112,Orta San Giulio,635,687,1322
46409,3114,Paruzzaro,1086,1099,2185
46511,3115,Pella,446,506,952
46613,3116,Pettenasco,683,691,1374
46715,3119,Pisano,388,428,816
46817,3120,Pogno,675,740,1415
46919,3121,Pombia,1098,1073,2171
47021,3122,Prato Sesia,934,934,1868
47123,3129,Recetto,503,460,963
47225,3130,Romagnano Sesia,1875,2019,3894
47327,3131,Romentino,2746,2875,5621
47429,3133,San Maurizio d'Opaglio,1481,1574,3055
47531,3134,San Nazzaro Sesia,371,367,738
47633,3135,San Pietro Mosezzo,1002,993,1995
47735,3138,Sillavengo,285,277,562
47837,3139,Sizzano,692,738,1430
47939,3140,Soriso,367,394,761
48041,3141,Sozzago,518,552,1070
48143,3143,Suno,1354,1411,2765
48245,3144,Terdobbiate,236,234,470
48347,3146,Tornaco,456,476,932
48449,3149,Trecate,10225,10490,20715
48551,3153,Vaprio d'Agogna,482,510,992
48653,3154,Varallo Pombia,2397,2517,4914
48755,3158,Vespolate,1008,1045,2053
48857,3159,Vicolungo,428,448,876
48959,3164,Vinzaglio,312,249,561
49061,3166,Gattico-Veruno,2514,2749,5263
49163,4001,Acceglio,78,80,158
49265,4002,Aisone,110,110,220
49367,4003,Alba,14903,16603,31506
49469,4004,Albaretto della Torre,111,113,224
49571,4005,Alto,65,65,130
49673,4006,Argentera,37,40,77
49775,4007,Arguello,105,94,199
49877,4008,Bagnasco,494,526,1020
49979,4009,Bagnolo Piemonte,2951,3002,5953
50081,4010,Baldissero d'Alba,544,516,1060
50183,4011,Barbaresco,314,316,630
50285,4012,Barge,3802,3814,7616
50387,4013,Barolo,330,360,690
50489,4014,Bastia Mondovì,336,331,667
50591,4015,Battifollo,114,98,212
50693,4016,Beinette,1720,1728,3448
50795,4017,Bellino,56,48,104
50897,4018,Belvedere Langhe,171,197,368
50999,4019,Bene Vagienna,1858,1807,3665
51101,4020,Benevello,238,238,476
51203,4021,Bergolo,28,28,56
51305,4022,Bernezzo,2057,2099,4156
51407,4023,Bonvicino,46,52,98
51509,4024,Borgomale,186,199,385
51611,4025,Borgo San Dalmazzo,6067,6375,12442
51713,4026,Bosia,87,93,180
51815,4027,Bossolasco,302,336,638
51917,4028,Boves,4859,4959,9818
52019,4029,Bra,14272,15384,29656
52121,4030,Briaglia,159,148,307
52223,4031,Briga Alta,26,14,40
52325,4032,Brondello,155,127,282
52427,4033,Brossasco,531,517,1048
52529,4034,Busca,5124,5050,10174
52631,4035,Camerana,301,293,594
52733,4037,Canale,2763,2846,5609
52835,4038,Canosio,45,37,82
52937,4039,Caprauna,53,44,97
53039,4040,Caraglio,3356,3401,6757
53141,4041,Caramagna Piemonte,1537,1553,3090
53243,4042,Cardè,559,588,1147
53345,4043,Carrù,2166,2220,4386
53447,4044,Cartignano,86,88,174
53549,4045,Casalgrasso,739,699,1438
53651,4046,Castagnito,1086,1108,2194
53753,4047,Casteldelfino,79,79,158
53855,4049,Castelletto Stura,689,691,1380
53957,4050,Castelletto Uzzone,170,144,314
54059,4051,Castellinaldo d'Alba,466,458,924
54161,4052,Castellino Tanaro,155,142,297
54263,4053,Castelmagno,39,21,60
54365,4054,Castelnuovo di Ceva,50,56,106
54467,4055,Castiglione Falletto,355,344,699
54569,4056,Castiglione Tinella,402,427,829
54671,4057,Castino,260,226,486
54773,4058,Cavallerleone,377,309,686
54875,4059,Cavallermaggiore,2699,2733,5432
54977,4060,Celle di Macra,51,37,88
55079,4061,Centallo,3637,3381,7018
55181,4062,Ceresole Alba,1049,1005,2054
55283,4063,Cerretto Langhe,226,204,430
55385,4064,Cervasca,2578,2556,5134
55487,4065,Cervere,1133,1129,2262
55589,4066,Ceva,2801,2896,5697
55691,4067,Cherasco,4576,4714,9290
55793,4068,Chiusa di Pesio,1832,1818,3650
55895,4069,Cigliè,95,90,185
55997,4070,Cissone,48,38,86
56099,4071,Clavesana,399,406,805
56201,4072,Corneliano d'Alba,1041,1105,2146
56303,4073,Cortemilia,1090,1181,2271
56405,4074,Cossano Belbo,479,473,952
56507,4075,Costigliole Saluzzo,1674,1625,3299
56609,4076,Cravanzana,180,185,365
56711,4077,Crissolo,90,75,165
56813,4078,Cuneo,26848,29296,56144
56915,4079,Demonte,1007,952,1959
57017,4080,Diano d'Alba,1820,1801,3621
57119,4081,Dogliani,2322,2369,4691
57221,4082,Dronero,3416,3602,7018
57323,4083,Elva,53,41,94
57425,4084,Entracque,476,383,859
57527,4085,Envie,981,1008,1989
57629,4086,Farigliano,885,892,1777
57731,4087,Faule,245,243,488
57833,4088,Feisoglio,148,157,305
57935,4089,Fossano,12092,12133,24225
58037,4090,Frabosa Soprana,405,347,752
58139,4091,Frabosa Sottana,831,699,1530
58241,4092,Frassino,150,119,269
58343,4093,Gaiola,300,283,583
58445,4094,Gambasca,187,163,350
58547,4095,Garessio,1486,1570,3056
58649,4096,Genola,1317,1336,2653
58751,4097,Gorzegno,137,136,273
58853,4098,Gottasecca,69,72,141
58955,4099,Govone,1074,1143,2217
59057,4100,Grinzane Cavour,995,1033,2028
59159,4101,Guarene,1775,1817,3592
59261,4102,Igliano,32,33,65
59363,4103,Isasca,46,36,82
59465,4104,Lagnasco,737,695,1432
59567,4105,La Morra,1403,1366,2769
59669,4106,Lequio Berria,255,209,464
59771,4107,Lequio Tanaro,374,367,741
59873,4108,Lesegno,421,408,829
59975,4109,Levice,107,103,210
60077,4110,Limone Piemonte,739,718,1457
60179,4111,Lisio,91,97,188
60281,4112,Macra,28,28,56
60383,4113,Magliano Alfieri,1049,1147,2196
60485,4114,Magliano Alpi,1100,1131,2231
60587,4115,Mango,657,661,1318
60689,4116,Manta,1838,1948,3786
60791,4117,Marene,1673,1650,3323
60893,4118,Margarita,713,727,1440
60995,4119,Marmora,31,30,61
61097,4120,Marsaglia,107,115,222
61199,4121,Martiniana Po,388,359,747
61301,4122,Melle,158,130,288
61403,4123,Moiola,118,99,217
61505,4124,Mombarcaro,134,130,264
61607,4125,Mombasiglio,284,326,610
61709,4126,Monastero di Vasco,621,670,1291
61811,4127,Monasterolo Casotto,45,39,84
61913,4128,Monasterolo di Savigliano,684,699,1383
62015,4129,Monchiero,293,285,578
62117,4130,Mondovì,10942,11464,22406
62219,4131,Monesiglio,286,335,621
62321,4132,Monforte d'Alba,978,1017,1995
62423,4133,Montà,2252,2449,4701
62525,4134,Montaldo di Mondovì,269,287,556
62627,4135,Montaldo Roero,418,428,846
62729,4136,Montanera,378,371,749
62831,4137,Montelupo Albese,238,247,485
62933,4138,Montemale di Cuneo,118,111,229
63035,4139,Monterosso Grana,281,245,526
63137,4140,Monteu Roero,812,792,1604
63239,4141,Montezemolo,124,110,234
63341,4142,Monticello d'Alba,1154,1213,2367
63443,4143,Moretta,2015,2067,4082
63545,4144,Morozzo,1003,1001,2004
63647,4145,Murazzano,416,416,832
63749,4146,Murello,485,464,949
63851,4147,Narzole,1724,1772,3496
63953,4148,Neive,1678,1778,3456
64055,4149,Neviglie,181,188,369
64157,4150,Niella Belbo,184,177,361
64259,4151,Niella Tanaro,538,477,1015
64361,4152,Novello,486,497,983
64463,4153,Nucetto,200,210,410
64565,4154,Oncino,47,31,78
64667,4155,Ormea,820,767,1587
64769,4156,Ostana,51,34,85
64871,4157,Paesana,1342,1371,2713
64973,4158,Pagno,280,280,560
65075,4159,Pamparato,159,136,295
65177,4160,Paroldo,95,112,207
65279,4161,Perletto,144,125,269
65381,4162,Perlo,58,56,114
65483,4163,Peveragno,2762,2838,5600
65585,4164,Pezzolo Valle Uzzone,174,169,343
65687,4165,Pianfei,1074,1034,2108
65789,4166,Piasco,1362,1376,2738
65891,4167,Pietraporzio,39,34,73
65993,4168,Piobesi d'Alba,685,669,1354
66095,4169,Piozzo,486,494,980
66197,4170,Pocapaglia,1654,1674,3328
66299,4171,Polonghera,560,580,1140
66401,4172,Pontechianale,87,76,163
66503,4173,Pradleves,118,112,230
66605,4174,Prazzo,82,89,171
66707,4175,Priero,260,263,523
66809,4176,Priocca,983,1008,1991
66911,4177,Priola,350,337,687
67013,4178,Prunetto,210,213,423
67115,4179,Racconigi,4941,4999,9940
67217,4180,Revello,2137,2136,4273
67319,4181,Rifreddo,526,518,1044
67421,4182,Rittana,47,57,104
67523,4183,Roaschia,51,56,107
67625,4184,Roascio,51,49,100
67727,4185,Robilante,1124,1136,2260
67829,4186,Roburent,251,240,491
67931,4187,Roccabruna,750,802,1552
68033,4188,Rocca Cigliè,64,70,134
68135,4189,Rocca de' Baldi,806,816,1622
68237,4190,Roccaforte Mondovì,1131,1012,2143
68339,4191,Roccasparvera,382,361,743
68441,4192,Roccavione,1336,1317,2653
68543,4193,Rocchetta Belbo,85,75,160
68645,4194,Roddi,821,809,1630
68747,4195,Roddino,221,192,413
68849,4196,Rodello,468,489,957
68951,4197,Rossana,451,415,866
69053,4198,Ruffia,189,174,363
69155,4199,Sale delle Langhe,255,252,507
69257,4200,Sale San Giovanni,86,86,172
69359,4201,Saliceto,609,647,1256
69461,4202,Salmour,385,339,724
69563,4203,Saluzzo,8421,8832,17253
69665,4204,Sambuco,43,44,87
69767,4205,Sampeyre,492,501,993
69869,4206,San Benedetto Belbo,79,84,163
69971,4207,San Damiano Macra,210,198,408
70073,4208,Sanfrè,1487,1555,3042
70175,4209,Sanfront,1174,1180,2354
70277,4210,San Michele Mondovì,930,1003,1933
70379,4211,Sant'Albano Stura,1214,1151,2365
70481,4212,Santa Vittoria d'Alba,1428,1442,2870
70583,4213,Santo Stefano Belbo,1992,2035,4027
70685,4214,Santo Stefano Roero,657,713,1370
70787,4215,Savigliano,10531,11074,21605
70889,4216,Scagnello,83,92,175
70991,4217,Scarnafigi,1071,1067,2138
71093,4218,Serralunga d'Alba,291,284,575
71195,4219,Serravalle Langhe,158,140,298
71297,4220,Sinio,263,248,511
71399,4221,Somano,172,154,326
71501,4222,Sommariva del Bosco,3128,3205,6333
71603,4223,Sommariva Perno,1350,1419,2769
71705,4224,Stroppo,50,53,103
71807,4225,Tarantasca,1112,1045,2157
71909,4226,Torre Bormida,88,83,171
72011,4227,Torre Mondovì,238,238,476
72113,4228,Torre San Giorgio,348,384,732
72215,4229,Torresina,21,27,48
72317,4230,Treiso,405,371,776
72419,4231,Trezzo Tinella,163,146,309
72521,4232,Trinità,1117,1129,2246
72623,4233,Valdieri,475,435,910
72725,4234,Valgrana,393,384,777
72827,4235,Valloriate,61,46,107
72929,4237,Venasca,668,720,1388
73031,4238,Verduno,277,283,560
73133,4239,Vernante,556,596,1152
73235,4240,Verzuolo,3143,3281,6424
73337,4241,Vezza d'Alba,1153,1132,2285
73439,4242,Vicoforte,1534,1589,3123
73541,4243,Vignolo,1283,1292,2575
73643,4244,Villafalletto,1446,1458,2904
73745,4245,Villanova Mondovì,2837,2957,5794
73847,4246,Villanova Solaro,385,355,740
73949,4247,Villar San Costanzo,780,755,1535
74051,4248,Vinadio,310,295,605
74153,4249,Viola,182,177,359
74255,4250,Vottignasco,259,253,512
74357,5001,Agliano Terme,808,784,1592
74459,5002,Albugnano,262,243,505
74561,5003,Antignano,473,488,961
74663,5004,Aramengo,284,281,565
74765,5005,Asti,36439,39587,76026
74867,5006,Azzano d'Asti,170,198,368
74969,5007,Baldichieri d'Asti,557,578,1135
75071,5008,Belveglio,158,167,325
75173,5009,Berzano di San Pietro,215,200,415
75275,5010,Bruno,155,156,311
75377,5011,Bubbio,397,440,837
75479,5012,Buttigliera d'Asti,1291,1251,2542
75581,5013,Calamandrana,852,878,1730
75683,5014,Calliano,647,631,1278
75785,5015,Calosso,640,604,1244
75887,5016,Camerano Casasco,223,219,442
75989,5017,Canelli,5079,5332,10411
76091,5018,Cantarana,496,499,995
76193,5019,Capriglio,160,140,300
76295,5020,Casorzo,296,322,618
76397,5021,Cassinasco,315,292,607
76499,5022,Castagnole delle Lanze,1827,1921,3748
76601,5023,Castagnole Monferrato,595,594,1189
76703,5024,Castel Boglione,336,273,609
76805,5025,Castell'Alfero,1315,1356,2671
76907,5026,Castellero,138,152,290
77009,5027,Castelletto Molina,70,86,156
77111,5028,Castello di Annone,1016,912,1928
77213,5029,Castelnuovo Belbo,408,439,847
77315,5030,Castelnuovo Calcea,373,360,733
77417,5031,Castelnuovo Don Bosco,1557,1610,3167
77519,5032,Castel Rocchero,197,194,391
77621,5033,Cellarengo,352,350,702
77723,5034,Celle Enomondo,234,243,477
77825,5035,Cerreto d'Asti,110,109,219
77927,5036,Cerro Tanaro,302,305,607
78029,5037,Cessole,189,199,388
78131,5038,Chiusano d'Asti,108,115,223
78233,5039,Cinaglio,217,226,443
78335,5040,Cisterna d'Asti,622,602,1224
78437,5041,Coazzolo,142,137,279
78539,5042,Cocconato,726,718,1444
78641,5044,Corsione,111,112,223
78743,5045,Cortandone,157,158,315
78845,5046,Cortanze,143,137,280
78947,5047,Cortazzone,302,309,611
79049,5048,Cortiglione,275,276,551
79151,5049,Cossombrato,241,267,508
79253,5050,Costigliole d'Asti,2855,2916,5771
79355,5051,Cunico,246,237,483
79457,5052,Dusino San Michele,535,512,1047
79559,5053,Ferrere,772,784,1556
79661,5054,Fontanile,264,289,553
79763,5055,Frinco,380,368,748
79865,5056,Grana,288,307,595
79967,5057,Grazzano Badoglio,298,311,609
80069,5058,Incisa Scapaccino,1107,1079,2186
80171,5059,Isola d'Asti,992,1038,2030
80273,5060,Loazzolo,164,166,330
80375,5061,Maranzana,137,120,257
80477,5062,Maretto,197,181,378
80579,5063,Moasca,258,253,511
80681,5064,Mombaldone,107,93,200
80783,5065,Mombaruzzo,535,532,1067
80885,5066,Mombercelli,1053,1096,2149
80987,5067,Monale,507,497,1004
81089,5068,Monastero Bormida,415,502,917
81191,5069,Moncalvo,1365,1496,2861
81293,5070,Moncucco Torinese,441,449,890
81395,5071,Mongardino,447,447,894
81497,5072,Montabone,163,163,326
81599,5073,Montafia,476,465,941
81701,5074,Montaldo Scarampi,350,397,747
81803,5075,Montechiaro d'Asti,632,634,1266
81905,5076,Montegrosso d'Asti,1148,1158,2306
82007,5077,Montemagno,524,591,1115
82109,5079,Moransengo,99,90,189
82211,5080,Nizza Monferrato,4933,5357,10290
82313,5081,Olmo Gentile,38,36,74
82415,5082,Passerano Marmorito,226,207,433
82517,5083,Penango,232,235,467
82619,5084,Piea,295,284,579
82721,5085,Pino d'Asti,110,109,219
82823,5086,Piovà Massaia,303,303,606
82925,5087,Portacomaro,986,1041,2027
83027,5088,Quaranti,90,80,170
83129,5089,Refrancore,759,811,1570
83231,5090,Revigliasco d'Asti,389,397,786
83333,5091,Roatto,191,191,382
83435,5092,Robella,260,224,484
83537,5093,Rocca d'Arazzo,447,444,891
83639,5094,Roccaverano,215,180,395
83741,5095,Rocchetta Palafea,176,170,346
83843,5096,Rocchetta Tanaro,703,719,1422
83945,5097,San Damiano d'Asti,4108,4197,8305
84047,5098,San Giorgio Scarampi,57,54,111
84149,5099,San Martino Alfieri,335,323,658
84251,5100,San Marzano Oliveto,508,508,1016
84353,5101,San Paolo Solbrito,599,598,1197
84455,5103,Scurzolengo,276,269,545
84557,5104,Serole,56,57,113
84659,5105,Sessame,126,137,263
84761,5106,Settime,275,275,550
84863,5107,Soglio,74,72,146
84965,5108,Tigliole,846,873,1719
85067,5109,Tonco,404,405,809
85169,5110,Tonengo,115,122,237
85271,5111,Vaglio Serra,149,138,287
85373,5112,Valfenera,1217,1192,2409
85475,5113,Vesime,312,296,608
85577,5114,Viale,123,120,243
85679,5115,Viarigi,437,442,879
85781,5116,Vigliano d'Asti,409,384,793
85883,5117,Villafranca d'Asti,1467,1550,3017
85985,5118,Villanova d'Asti,2752,2923,5675
86087,5119,Villa San Secondo,179,202,381
86189,5120,Vinchio,296,280,576
86291,5121,Montiglio Monferrato,803,801,1604
86393,6001,Acqui Terme,9140,10464,19604
86495,6002,Albera Ligure,162,138,300
86597,6003,Alessandria,45060,48571,93631
86699,6004,Alfiano Natta,408,371,779
86801,6005,Alice Bel Colle,405,341,746
86903,6007,Altavilla Monferrato,233,197,430
87005,6008,Alzano Scrivia,180,170,350
87107,6009,Arquata Scrivia,3084,3284,6368
87209,6010,Avolasca,131,131,262
87311,6011,Balzola,656,691,1347
87413,6012,Basaluzzo,1054,1017,2071
87515,6013,Bassignana,805,869,1674
87617,6014,Belforte Monferrato,261,246,507
87719,6015,Bergamasco,355,365,720
87821,6016,Berzano di Tortona,75,79,154
87923,6017,Bistagno,877,917,1794
88025,6018,Borghetto di Borbera,983,974,1957
88127,6019,Borgoratto Alessandrino,257,293,550
88229,6020,Borgo San Martino,686,712,1398
88331,6021,Bosco Marengo,1193,1167,2360
88433,6022,Bosio,605,573,1178
88535,6023,Bozzole,177,157,334
88637,6024,Brignano-Frascata,228,209,437
88739,6025,Cabella Ligure,266,237,503
88841,6026,Camagna Monferrato,246,248,494
88943,6027,Camino,374,377,751
89045,6028,Cantalupo Ligure,237,239,476
89147,6029,Capriata d'Orba,904,940,1844
89249,6030,Carbonara Scrivia,552,575,1127
89351,6031,Carentino,168,150,318
89453,6032,Carezzano,207,233,440
89555,6033,Carpeneto,473,475,948
89657,6034,Carrega Ligure,51,34,85
89759,6035,Carrosio,261,239,500
89861,6036,Cartosio,353,384,737
89963,6037,Casal Cermelli,596,625,1221
90065,6038,Casaleggio Boiro,196,186,382
90167,6039,Casale Monferrato,15884,17841,33725
90269,6040,Casalnoceto,480,498,978
90371,6041,Casasco,68,64,132
90473,6043,Cassine,1479,1464,2943
90575,6044,Cassinelle,453,428,881
90677,6045,Castellania,44,45,89
90779,6046,Castellar Guidobono,209,189,398
90881,6047,Castellazzo Bormida,2203,2323,4526
90983,6048,Castelletto d'Erro,68,81,149
91085,6049,Castelletto d'Orba,969,991,1960
91187,6050,Castelletto Merli,221,227,448
91289,6051,Castelletto Monferrato,750,751,1501
91391,6052,Castelnuovo Bormida,349,351,700
91493,6053,Castelnuovo Scrivia,2484,2640,5124
91595,6054,Castelspina,201,219,420
91697,6055,Cavatore,126,143,269
91799,6056,Cella Monte,246,253,499
91901,6057,Cereseto,209,194,403
92003,6058,Cerreto Grue,150,153,303
92105,6059,Cerrina Monferrato,662,695,1357
92207,6060,Coniolo,226,227,453
92309,6061,Conzano,488,478,966
92411,6062,Costa Vescovato,169,158,327
92513,6063,Cremolino,546,522,1068
92615,6064,Cuccaro Monferrato,152,175,327
92717,6065,Denice,85,88,173
92819,6066,Dernice,91,90,181
92921,6067,Fabbrica Curone,295,315,610
93023,6068,Felizzano,1107,1146,2253
93125,6069,Fraconalto,172,145,317
93227,6070,Francavilla Bisio,248,257,505
93329,6071,Frascaro,209,223,432
93431,6072,Frassinello Monferrato,240,260,500
93533,6073,Frassineto Po,665,716,1381
93635,6074,Fresonara,346,323,669
93737,6075,Frugarolo,952,1000,1952
93839,6076,Fubine Monferrato,772,832,1604
93941,6077,Gabiano,564,531,1095
94043,6078,Gamalero,391,435,826
94145,6079,Garbagna,334,327,661
94247,6081,Gavi,2234,2261,4495
94349,6082,Giarole,328,376,704
94451,6083,Gremiasco,159,158,317
94553,6084,Grognardo,131,110,241
94655,6085,Grondona,236,253,489
94757,6086,Guazzora,156,147,303
94859,6087,Isola Sant'Antonio,360,325,685
94961,6088,Lerma,397,423,820
95063,6089,Lu,524,553,1077
95165,6090,Malvicino,33,46,79
95267,6091,Masio,698,666,1364
95369,6092,Melazzo,643,650,1293
95471,6093,Merana,94,92,186
95573,6094,Mirabello Monferrato,655,654,1309
95675,6095,Molare,997,1068,2065
95777,6096,Molino dei Torti,309,278,587
95879,6097,Mombello Monferrato,504,506,1010
95981,6098,Momperone,111,99,210
96083,6099,Moncestino,89,107,196
96185,6100,Mongiardino Ligure,80,76,156
96287,6101,Monleale,280,286,566
96389,6102,Montacuto,133,119,252
96491,6103,Montaldeo,123,126,249
96593,6104,Montaldo Bormida,326,311,637
96695,6105,Montecastello,158,154,312
96797,6106,Montechiaro d'Acqui,279,258,537
96899,6107,Montegioco,162,142,304
97001,6108,Montemarzino,151,150,301
97103,6109,Morano sul Po,673,717,1390
97205,6110,Morbello,221,201,422
97307,6111,Mornese,351,370,721
97409,6112,Morsasco,311,318,629
97511,6113,Murisengo,654,710,1364
97613,6114,Novi Ligure,13589,14697,28286
97715,6115,Occimiano,632,656,1288
97817,6116,Odalengo Grande,210,213,423
97919,6117,Odalengo Piccolo,133,122,255
98021,6118,Olivola,55,58,113
98123,6119,Orsara Bormida,202,200,402
98225,6120,Ottiglio,310,304,614
98327,6121,Ovada,5412,5887,11299
98429,6122,Oviglio,615,619,1234
98531,6123,Ozzano Monferrato,697,705,1402
98633,6124,Paderna,96,93,189
98735,6125,Pareto,284,249,533
98837,6126,Parodi Ligure,342,308,650
98939,6127,Pasturana,608,668,1276
99041,6128,Pecetto di Valenza,602,602,1204
99143,6129,Pietra Marazzi,442,459,901
99245,6131,Pomaro Monferrato,191,164,355
99347,6132,Pontecurone,1765,1785,3550
99449,6133,Pontestura,698,722,1420
99551,6134,Ponti,286,282,568
99653,6135,Ponzano Monferrato,163,174,337
99755,6136,Ponzone,538,474,1012
99857,6137,Pozzol Groppo,150,141,291
99959,6138,Pozzolo Formigaro,2320,2349,4669
100061,6139,Prasco,247,245,492
100163,6140,Predosa,968,1007,1975
100265,6141,Quargnento,686,723,1409
100367,6142,Quattordio,779,808,1587
100469,6143,Ricaldone,342,305,647
100571,6144,Rivalta Bormida,700,705,1405
100673,6145,Rivarone,237,171,408
100775,6146,Roccaforte Ligure,75,49,124
100877,6147,Rocca Grimalda,758,716,1474
100979,6148,Rocchetta Ligure,117,95,212
101081,6149,Rosignano Monferrato,730,781,1511
101183,6150,Sala Monferrato,163,171,334
101285,6151,Sale,1966,2077,4043
101387,6152,San Cristoforo,284,296,580
101489,6153,San Giorgio Monferrato,591,624,1215
101591,6154,San Salvatore Monferrato,2060,2152,4212
101693,6155,San Sebastiano Curone,268,315,583
101795,6156,Sant'Agata Fossili,193,207,400
101897,6157,Sardigliano,197,198,395
101999,6158,Sarezzano,579,594,1173
102101,6159,Serralunga di Crea,263,272,535
102203,6160,Serravalle Scrivia,2985,3030,6015
102305,6161,Sezzadio,612,645,1257
102407,6162,Silvano d'Orba,952,983,1935
102509,6163,Solero,811,854,1665
102611,6164,Solonghello,102,110,212
102713,6165,Spigno Monferrato,504,503,1007
102815,6166,Spineto Scrivia,187,180,367
102917,6167,Stazzano,1186,1209,2395
103019,6168,Strevi,963,987,1950
103121,6169,Tagliolo Monferrato,774,768,1542
103223,6170,Tassarolo,332,296,628
103325,6171,Terruggia,442,486,928
103427,6172,Terzo,440,411,851
103529,6173,Ticineto,642,691,1333
103631,6174,Tortona,13100,14191,27291
103733,6175,Treville,141,139,280
103835,6176,Trisobbio,324,355,679
103937,6177,Valenza,8825,9809,18634
104039,6178,Valmacca,475,529,1004
104141,6179,Vignale Monferrato,469,512,981
104243,6180,Vignole Borbera,1017,1051,2068
104345,6181,Viguzzolo,1547,1551,3098
104447,6182,Villadeati,245,242,487
104549,6183,Villalvernia,431,461,892
104651,6184,Villamiroglio,157,149,306
104753,6185,Villanova Monferrato,893,968,1861
104855,6186,Villaromagnano,327,343,670
104957,6187,Visone,650,587,1237
105059,6188,Volpedo,579,612,1191
105161,6189,Volpeglino,71,61,132
105263,6190,Voltaggio,346,363,709
105365,6191,Cassano Spinola,870,934,1804
105467,6192,Alluvioni Piovera,844,894,1738
105569,7001,Allein,106,105,211
105671,7002,Antey-Saint-André,283,288,571
105773,7003,Aosta,15903,18105,34008
105875,7004,Arnad,600,654,1254
105977,7005,Arvier,430,440,870
106079,7006,Avise,145,157,302
106181,7007,Ayas,687,673,1360
106283,7008,Aymavilles,1008,1058,2066
106385,7009,Bard,53,65,118
106487,7010,Bionaz,118,107,225
106589,7011,Brissogne,497,463,960
106691,7012,Brusson,434,459,893
106793,7013,Challand-Saint-Anselme,372,381,753
106895,7014,Challand-Saint-Victor,270,285,555
106997,7015,Chambave,471,458,929
107099,7016,Chamois,55,42,97
107201,7017,Champdepraz,345,372,717
107303,7018,Champorcher,206,193,399
107405,7019,Charvensod,1189,1241,2430
107507,7020,Châtillon,2246,2385,4631
107609,7021,Cogne,673,678,1351
107711,7022,Courmayeur,1369,1369,2738
107813,7023,Donnas,1202,1299,2501
107915,7024,Doues,251,258,509
108017,7025,Emarèse,115,105,220
108119,7026,Etroubles,255,238,493
108221,7027,Fénis,879,913,1792
108323,7028,Fontainemore,230,199,429
108425,7029,Gaby,226,232,458
108527,7030,Gignod,870,867,1737
108629,7031,Gressan,1663,1715,3378
108731,7032,Gressoney-La-Trinité,144,157,301
108833,7033,Gressoney-Saint-Jean,407,404,811
108935,7034,Hône,552,593,1145
109037,7035,Introd,323,322,645
109139,7036,Issime,192,205,397
109241,7037,Issogne,681,692,1373
109343,7038,Jovençan,364,363,727
109445,7039,La Magdeleine,61,46,107
109547,7040,La Salle,1006,1010,2016
109649,7041,La Thuile,398,404,802
109751,7042,Lillianes,217,230,447
109853,7043,Montjovet,892,864,1756
109955,7044,Morgex,1026,1086,2112
110057,7045,Nus,1456,1508,2964
110159,7046,Ollomont,85,77,162
110261,7047,Oyace,115,92,207
110363,7048,Perloz,235,232,467
110465,7049,Pollein,772,767,1539
110567,7050,Pontboset,95,84,179
110669,7051,Pontey,403,402,805
110771,7052,Pont-Saint-Martin,1772,1911,3683
110873,7053,Pré-Saint-Didier,539,476,1015
110975,7054,Quart,2063,2030,4093
111077,7055,Rhêmes-Notre-Dame,45,34,79
111179,7056,Rhêmes-Saint-Georges,89,83,172
111281,7057,Roisan,511,497,1008
111383,7058,Saint-Christophe,1735,1764,3499
111485,7059,Saint-Denis,196,179,375
111587,7060,Saint-Marcel,670,674,1344
111689,7061,Saint-Nicolas,162,155,317
111791,7062,Saint-Oyen,83,111,194
111893,7063,Saint-Pierre,1620,1581,3201
111995,7064,Saint-Rhémy-en-Bosses,167,151,318
112097,7065,Saint-Vincent,2222,2360,4582
112199,7066,Sarre,2365,2483,4848
112301,7067,Torgnon,304,265,569
112403,7068,Valgrisenche,108,82,190
112505,7069,Valpelline,320,278,598
112607,7070,Valsavarenche,82,87,169
112709,7071,Valtournenche,1180,1111,2291
112811,7072,Verrayes,648,638,1286
112913,7073,Verrès,1282,1351,2633
113015,7074,Villeneuve,685,600,1285
113117,8001,Airole,201,191,392
113219,8002,Apricale,321,303,624
113321,8003,Aquila d'Arroscia,79,77,156
113423,8004,Armo,56,54,110
113525,8005,Aurigo,157,165,322
113627,8006,Badalucco,534,580,1114
113729,8007,Bajardo,198,138,336
113831,8008,Bordighera,4812,5616,10428
113933,8009,Borghetto d'Arroscia,231,200,431
114035,8010,Borgomaro,450,392,842
114137,8011,Camporosso,2768,2798,5566
114239,8012,Caravonica,154,117,271
114341,8014,Castellaro,607,642,1249
114443,8015,Castel Vittorio,149,131,280
114545,8016,Ceriana,598,572,1170
114647,8017,Cervo,551,595,1146
114749,8018,Cesio,138,135,273
114851,8019,Chiusanico,295,285,580
114953,8020,Chiusavecchia,262,260,522
115055,8021,Cipressa,618,635,1253
115157,8022,Civezza,300,291,591
115259,8023,Cosio d'Arroscia,91,105,196
115361,8024,Costarainera,390,401,791
115463,8025,Diano Arentino,340,367,707
115565,8026,Diano Castello,1095,1150,2245
115667,8027,Diano Marina,2686,3147,5833
115769,8028,Diano San Pietro,578,554,1132
115871,8029,Dolceacqua,1003,1079,2082
115973,8030,Dolcedo,672,688,1360
116075,8031,Imperia,20376,22074,42450
116177,8032,Isolabona,329,346,675
116279,8033,Lucinasco,165,126,291
116381,8034,Mendatica,103,77,180
116483,8035,Molini di Triora,326,277,603
116585,8037,Montegrosso Pian Latte,61,62,123
116687,8038,Olivetta San Michele,106,101,207
116789,8039,Ospedaletti,1543,1731,3274
116891,8040,Perinaldo,415,434,849
116993,8041,Pietrabruna,229,229,458
117095,8042,Pieve di Teco,657,704,1361
117197,8043,Pigna,383,412,795
117299,8044,Pompeiana,421,433,854
117401,8045,Pontedassio,1150,1152,2302
117503,8046,Pornassio,417,286,703
117605,8047,Prelà,245,230,475
117707,8048,Ranzo,260,285,545
117809,8049,Rezzo,157,164,321
117911,8050,Riva Ligure,1396,1428,2824
118013,8051,Rocchetta Nervina,149,142,291
118115,8052,San Bartolomeo al Mare,1463,1641,3104
118217,8053,San Biagio della Cima,619,666,1285
118319,8054,San Lorenzo al Mare,603,666,1269
118421,8055,Sanremo,25919,28679,54598
118523,8056,Santo Stefano al Mare,1040,1091,2131
118625,8057,Seborga,142,152,294
118727,8058,Soldano,516,499,1015
118829,8059,Taggia,6585,7331,13916
118931,8060,Terzorio,117,119,236
119033,8061,Triora,193,171,364
119135,8062,Vallebona,662,649,1311
119237,8063,Vallecrosia,3309,3679,6988
119339,8064,Vasia,204,194,398
119441,8065,Ventimiglia,11826,12261,24087
119543,8066,Vessalico,146,124,270
119645,8067,Villa Faraldi,240,234,474
119747,8068,Montalto Carpasio,269,248,517
119849,9001,Alassio,4943,5806,10749
119951,9002,Albenga,11754,12337,24091
120053,9003,Albissola Marina,2540,2816,5356
120155,9004,Albisola Superiore,4620,5262,9882
120257,9005,Altare,991,1017,2008
120359,9006,Andora,3602,3898,7500
120461,9007,Arnasco,315,295,610
120563,9008,Balestrino,260,280,540
120665,9009,Bardineto,371,382,753
120767,9010,Bergeggi,515,575,1090
120869,9011,Boissano,1245,1229,2474
120971,9012,Borghetto Santo Spirito,2198,2492,4690
121073,9013,Borgio Verezzi,1006,1160,2166
121175,9014,Bormida,179,180,359
121277,9015,Cairo Montenotte,6393,6612,13005
121379,9016,Calice Ligure,834,861,1695
121481,9017,Calizzano,722,733,1455
121583,9018,Carcare,2589,2888,5477
121685,9019,Casanova Lerrone,361,365,726
121787,9020,Castelbianco,151,168,319
121889,9021,Castelvecchio di Rocca Barbena,71,75,146
121991,9022,Celle Ligure,2441,2690,5131
122093,9023,Cengio,1670,1748,3418
122195,9024,Ceriale,2710,2839,5549
122297,9025,Cisano sul Neva,1053,1075,2128
122399,9026,Cosseria,535,540,1075
122501,9027,Dego,976,998,1974
122603,9028,Erli,116,111,227
122705,9029,Finale Ligure,5517,6023,11540
122807,9030,Garlenda,617,628,1245
122909,9031,Giustenice,497,494,991
123011,9032,Giusvalla,232,200,432
123113,9033,Laigueglia,826,952,1778
123215,9034,Loano,5114,5994,11108
123317,9035,Magliolo,502,473,975
123419,9036,Mallare,530,564,1094
123521,9037,Massimino,58,49,107
123623,9038,Millesimo,1617,1732,3349
123725,9039,Mioglia,253,254,507
123827,9040,Murialdo,432,387,819
123929,9041,Nasino,98,91,189
124031,9042,Noli,1280,1352,2632
124133,9043,Onzo,102,112,214
124235,9044,Orco Feglino,458,443,901
124337,9045,Ortovero,782,807,1589
124439,9046,Osiglia,241,226,467
124541,9047,Pallare,463,463,926
124643,9048,Piana Crixia,394,412,806
124745,9049,Pietra Ligure,4129,4602,8731
124847,9050,Plodio,319,312,631
124949,9051,Pontinvrea,436,382,818
125051,9052,Quiliano,3409,3644,7053
125153,9053,Rialto,285,279,564
125255,9054,Roccavignale,377,384,761
125357,9055,Sassello,889,853,1742
125459,9056,Savona,28336,32106,60442
125561,9057,Spotorno,1732,1945,3677
125663,9058,Stella,1494,1492,2986
125765,9059,Stellanello,428,380,808
125867,9060,Testico,96,91,187
125969,9061,Toirano,1299,1356,2655
126071,9062,Tovo San Giacomo,1243,1306,2549
126173,9063,Urbe,359,348,707
126275,9064,Vado Ligure,4020,4296,8316
126377,9065,Varazze,6309,6684,12993
126479,9066,Vendone,172,193,365
126581,9067,Vezzi Portio,421,409,830
126683,9068,Villanova d'Albenga,1327,1349,2676
126785,9069,Zuccarello,147,164,311
126887,10001,Arenzano,5410,6006,11416
126989,10002,Avegno,1237,1271,2508
127091,10003,Bargagli,1348,1311,2659
127193,10004,Bogliasco,2153,2369,4522
127295,10005,Borzonasca,1061,955,2016
127397,10006,Busalla,2716,2774,5490
127499,10007,Camogli,2518,2723,5241
127601,10008,Campo Ligure,1431,1423,2854
127703,10009,Campomorone,3262,3466,6728
127805,10010,Carasco,1819,1921,3740
127907,10011,Casarza Ligure,3366,3502,6868
128009,10012,Casella,1602,1562,3164
128111,10013,Castiglione Chiavarese,761,837,1598
128213,10014,Ceranesi,1878,1878,3756
128315,10015,Chiavari,12682,14855,27537
128417,10016,Cicagna,1231,1210,2441
128519,10017,Cogoleto,4296,4642,8938
128621,10018,Cogorno,2803,2880,5683
128723,10019,Coreglia Ligure,135,123,258
128825,10020,Crocefieschi,280,247,527
128927,10021,Davagna,963,912,1875
129029,10022,Fascia,33,32,65
129131,10023,Favale di Malvaro,226,233,459
129233,10024,Fontanigorda,133,128,261
129335,10025,Genova,273361,304639,578000
129437,10026,Gorreto,41,47,88
129539,10027,Isola del Cantone,761,716,1477
129641,10028,Lavagna,5828,6738,12566
129743,10029,Leivi,1186,1239,2425
129845,10030,Lorsica,224,212,436
129947,10031,Lumarzo,761,756,1517
130049,10032,Masone,1804,1852,3656
130151,10033,Mele,1304,1360,2664
130253,10034,Mezzanego,757,752,1509
130355,10035,Mignanego,1784,1796,3580
130457,10036,Moconesi,1222,1244,2466
130559,10037,Moneglia,1306,1457,2763
130661,10038,Montebruno,122,103,225
130763,10039,Montoggio,1011,994,2005
130865,10040,Ne,1148,1112,2260
130967,10041,Neirone,452,405,857
131069,10042,Orero,276,261,537
131171,10043,Pieve Ligure,1237,1268,2505
131273,10044,Portofino,200,187,387
131375,10045,Propata,76,65,141
131477,10046,Rapallo,13960,15732,29692
131579,10047,Recco,4524,5108,9632
131681,10048,Rezzoaglio,473,478,951
131783,10049,Ronco Scrivia,2131,2164,4295
131885,10050,Rondanina,37,25,62
131987,10051,Rossiglione,1271,1380,2651
132089,10052,Rovegno,274,234,508
132191,10053,San Colombano Certenoli,1320,1302,2622
132293,10054,Santa Margherita Ligure,4138,4886,9024
132395,10055,Sant'Olcese,2897,2941,5838
132497,10056,Santo Stefano d'Aveto,563,523,1086
132599,10057,Savignone,1522,1545,3067
132701,10058,Serra Riccò,3857,3920,7777
132803,10059,Sestri Levante,8605,9564,18169
132905,10060,Sori,1940,2093,4033
133007,10061,Tiglieto,279,246,525
133109,10062,Torriglia,1118,1110,2228
133211,10063,Tribogna,320,281,601
133313,10064,Uscio,1078,1087,2165
133415,10065,Valbrevenna,439,343,782
133517,10066,Vobbia,202,178,380
133619,10067,Zoagli,1171,1253,2424
133721,11001,Ameglia,2095,2221,4316
133823,11002,Arcola,5139,5370,10509
133925,11003,Beverino,1165,1185,2350
134027,11004,Bolano,3771,3962,7733
134129,11005,Bonassola,390,439,829
134231,11006,Borghetto di Vara,433,468,901
134333,11007,Brugnato,638,646,1284
134435,11008,Calice al Cornoviglio,546,539,1085
134537,11009,Carro,265,262,527
134639,11010,Carrodano,252,235,487
134741,11011,Castelnuovo Magra,4091,4290,8381
134843,11012,Deiva Marina,654,692,1346
134945,11013,Follo,3136,3181,6317
135047,11014,Framura,321,324,645
135149,11015,La Spezia,44569,48660,93229
135251,11016,Lerici,4744,5309,10053
135353,11017,Levanto,2552,2836,5388
135455,11018,Maissana,332,271,603
135557,11019,Monterosso al Mare,638,771,1409
135659,11020,Luni,4117,4270,8387
135761,11021,Pignone,273,283,556
135863,11022,Portovenere,1721,1789,3510
135965,11023,Riccò del Golfo di Spezia,1772,1853,3625
136067,11024,Riomaggiore,724,759,1483
136169,11025,Rocchetta di Vara,357,329,686
136271,11026,Santo Stefano di Magra,4856,5045,9901
136373,11027,Sarzana,10583,11521,22104
136475,11028,Sesta Godano,672,683,1355
136577,11029,Varese Ligure,947,956,1903
136679,11030,Vernazza,395,405,800
136781,11031,Vezzano Ligure,3561,3786,7347
136883,11032,Zignago,251,256,507
136985,12001,Agra,208,191,399
137087,12002,Albizzate,2553,2698,5251
137189,12003,Angera,2617,2872,5489
137291,12004,Arcisate,4899,5167,10066
137393,12005,Arsago Seprio,2436,2461,4897
137495,12006,Azzate,2257,2429,4686
137597,12007,Azzio,396,373,769
137699,12008,Barasso,794,921,1715
137801,12009,Bardello,789,841,1630
137903,12010,Bedero Valcuvia,317,329,646
138005,12011,Besano,1273,1293,2566
138107,12012,Besnate,2753,2843,5596
138209,12013,Besozzo,4351,4633,8984
138311,12014,Biandronno,1625,1689,3314
138413,12015,Bisuschio,2103,2206,4309
138515,12016,Bodio Lomnago,1088,1129,2217
138617,12017,Brebbia,1575,1656,3231
138719,12018,Bregano,441,432,873
138821,12019,Brenta,834,837,1671
138923,12020,Brezzo di Bedero,628,575,1203
139025,12021,Brinzio,427,387,814
139127,12022,Brissago-Valtravaglia,600,623,1223
139229,12023,Brunello,464,478,942
139331,12024,Brusimpiano,592,610,1202
139433,12025,Buguggiate,1493,1600,3093
139535,12026,Busto Arsizio,40151,43477,83628
139637,12027,Cadegliano-Viconago,1055,1126,2181
139739,12028,Cadrezzate,908,962,1870
139841,12029,Cairate,3821,3850,7671
139943,12030,Cantello,2305,2411,4716
140045,12031,Caravate,1306,1259,2565
140147,12032,Cardano al Campo,7337,7619,14956
140249,12033,Carnago,3271,3386,6657
140351,12034,Caronno Pertusella,8884,9054,17938
140453,12035,Caronno Varesino,2423,2458,4881
140555,12036,Casale Litta,1317,1356,2673
140657,12037,Casalzuigno,670,700,1370
140759,12038,Casciago,1783,1909,3692
140861,12039,Casorate Sempione,2785,2936,5721
140963,12040,Cassano Magnago,10649,11082,21731
141065,12041,Cassano Valcuvia,325,346,671
141167,12042,Castellanza,6975,7541,14516
141269,12043,Castello Cabiaglio,281,278,559
141371,12044,Castelseprio,636,672,1308
141473,12045,Castelveccana,975,1014,1989
141575,12046,Castiglione Olona,3817,3868,7685
141677,12047,Castronno,2597,2597,5194
141779,12048,Cavaria con Premezzo,2934,2885,5819
141881,12049,Cazzago Brabbia,413,415,828
141983,12050,Cislago,5164,5248,10412
142085,12051,Cittiglio,1894,1984,3878
142187,12052,Clivio,910,1004,1914
142289,12053,Cocquio-Trevisago,2294,2446,4740
142391,12054,Comabbio,614,571,1185
142493,12055,Comerio,1373,1531,2904
142595,12056,Cremenaga,396,417,813
142697,12057,Crosio della Valle,307,290,597
142799,12058,Cuasso al Monte,1783,1810,3593
142901,12059,Cugliate-Fabiasco,1556,1523,3079
143003,12060,Cunardo,1420,1486,2906
143105,12061,Curiglia con Monteviasco,88,79,167
143207,12062,Cuveglio,1625,1729,3354
143309,12063,Cuvio,808,863,1671
143411,12064,Daverio,1496,1557,3053
143513,12065,Dumenza,765,720,1485
143615,12066,Duno,74,54,128
143717,12067,Fagnano Olona,6200,6298,12498
143819,12068,Ferno,3364,3432,6796
143921,12069,Ferrera di Varese,362,347,709
144023,12070,Gallarate,25923,27416,53339
144125,12071,Galliate Lombardo,470,524,994
144227,12072,Gavirate,4462,4865,9327
144329,12073,Gazzada Schianno,2249,2368,4617
144431,12074,Gemonio,1425,1456,2881
144533,12075,Gerenzano,5369,5539,10908
144635,12076,Germignaga,1896,2058,3954
144737,12077,Golasecca,1335,1364,2699
144839,12078,Gorla Maggiore,2472,2470,4942
144941,12079,Gorla Minore,4173,4191,8364
145043,12080,Gornate Olona,1121,1072,2193
145145,12081,Grantola,615,655,1270
145247,12082,Inarzo,527,540,1067
145349,12083,Induno Olona,5004,5307,10311
145451,12084,Ispra,2571,2738,5309
145553,12085,Jerago con Orago,2596,2660,5256
145655,12086,Lavena Ponte Tresa,2817,3078,5895
145757,12087,Laveno-Mombello,4071,4614,8685
145859,12088,Leggiuno,1819,1947,3766
145961,12089,Lonate Ceppino,2453,2576,5029
146063,12090,Lonate Pozzolo,5795,5931,11726
146165,12091,Lozza,617,633,1250
146267,12092,Luino,6860,7446,14306
146369,12093,Luvinate,659,671,1330
146471,12095,Malgesso,638,638,1276
146573,12096,Malnate,8062,8668,16730
146675,12097,Marchirolo,1712,1779,3491
146777,12098,Marnate,3928,4008,7936
146879,12099,Marzio,184,161,345
146981,12100,Masciago Primo,152,147,299
147083,12101,Mercallo,901,914,1815
147185,12102,Mesenzana,767,806,1573
147287,12103,Montegrino Valtravaglia,741,748,1489
147389,12104,Monvalle,964,990,1954
147491,12105,Morazzone,2095,2181,4276
147593,12106,Mornago,2496,2515,5011
147695,12107,Oggiona con Santo Stefano,2149,2183,4332
147797,12108,Olgiate Olona,6127,6414,12541
147899,12109,Origgio,3894,3986,7880
148001,12110,Orino,411,412,823
148103,12111,Osmate,405,413,818
148205,12113,Porto Ceresio,1424,1518,2942
148307,12114,Porto Valtravaglia,1132,1228,2360
148409,12115,Rancio Valcuvia,461,472,933
148511,12116,Ranco,641,667,1308
148613,12117,Saltrio,1511,1586,3097
148715,12118,Samarate,7929,8196,16125
148817,12119,Saronno,18804,20611,39415
148919,12120,Sesto Calende,5355,5725,11080
149021,12121,Solbiate Arno,2003,2117,4120
149123,12122,Solbiate Olona,2697,2749,5446
149225,12123,Somma Lombardo,8796,9148,17944
149327,12124,Sumirago,3016,3099,6115
149429,12125,Taino,1808,1875,3683
149531,12126,Ternate,1245,1315,2560
149633,12127,Tradate,9296,9687,18983
149735,12128,Travedona-Monate,1964,2093,4057
149837,12129,Tronzano Lago Maggiore,112,111,223
149939,12130,Uboldo,5340,5316,10656
150041,12131,Valganna,798,801,1599
150143,12132,Varano Borghi,1187,1303,2490
150245,12133,Varese,38356,42203,80559
150347,12134,Vedano Olona,3581,3846,7427
150449,12136,Venegono Inferiore,2970,3127,6097
150551,12137,Venegono Superiore,3637,3741,7378
150653,12138,Vergiate,4289,4427,8716
150755,12139,Viggiù,2499,2765,5264
150857,12140,Vizzola Ticino,297,279,576
150959,12141,Sangiano,771,750,1521
151061,12142,Maccagno con Pino e Veddasca,1262,1338,2600
151163,13003,Albavilla,3109,3245,6354
151265,13004,Albese con Cassano,2053,2175,4228
151367,13005,Albiolo,1371,1371,2742
151469,13006,Alserio,630,635,1265
151571,13007,Alzate Brianza,2471,2482,4953
151673,13009,Anzano del Parco,892,920,1812
151775,13010,Appiano Gentile,3761,4018,7779
151877,13011,Argegno,325,329,654
151979,13012,Arosio,2486,2601,5087
152081,13013,Asso,1738,1841,3579
152183,13015,Barni,284,281,565
152285,13021,Bene Lario,169,161,330
152387,13022,Beregazzo con Figliaro,1339,1428,2767
152489,13023,Binago,2406,2425,4831
152591,13024,Bizzarone,823,831,1654
152693,13025,Blessagno,145,137,282
152795,13026,Blevio,558,626,1184
152897,13028,Bregnano,3262,3241,6503
152999,13029,Brenna,1089,1059,2148
153101,13030,Brienno,154,175,329
153203,13032,Brunate,846,864,1710
153305,13034,Bulgarograsso,2074,2030,4104
153407,13035,Cabiate,3755,3738,7493
153509,13036,Cadorago,3972,4023,7995
153611,13037,Caglio,234,249,483
153713,13040,Campione d'Italia,944,1017,1961
153815,13041,Cantù,19537,20470,40007
153917,13042,Canzo,2528,2639,5167
154019,13043,Capiago Intimiano,2711,2824,5535
154121,13044,Carate Urio,554,614,1168
154223,13045,Carbonate,1513,1447,2960
154325,13046,Carimate,2246,2266,4512
154427,13047,Carlazzo,1525,1652,3177
154529,13048,Carugo,3281,3354,6635
154631,13052,Caslino d'Erba,805,844,1649
154733,13053,Casnate con Bernate,2445,2529,4974
154835,13055,Cassina Rizzardi,1617,1734,3351
154937,13058,Castelmarte,660,627,1287
155039,13059,Castelnuovo Bozzente,435,454,889
155141,13062,Cavargna,106,102,208
155243,13063,Cerano d'Intelvi,251,285,536
155345,13064,Cermenate,4548,4688,9236
155447,13065,Cernobbio,3208,3493,6701
155549,13068,Cirimido,1085,1051,2136
155651,13071,Claino con Osteno,286,264,550
155753,13074,Colonno,251,255,506
155855,13075,Como,39517,43005,82522
155957,13077,Corrido,408,423,831
156059,13083,Cremia,337,340,677
156161,13084,Cucciago,1707,1701,3408
156263,13085,Cusino,111,112,223
156365,13087,Dizzasco,295,324,619
156467,13089,Domaso,725,754,1479
156569,13090,Dongo,1626,1730,3356
156671,13092,Dosso del Liro,122,130,252
156773,13095,Erba,7796,8527,16323
156875,13097,Eupilio,1289,1303,2592
156977,13098,Faggeto Lario,609,598,1207
157079,13099,Faloppio,2366,2397,4763
157181,13100,Fenegrò,1606,1625,3231
157283,13101,Figino Serenza,2560,2588,5148
157385,13102,Fino Mornasco,4923,4937,9860
157487,13106,Garzeno,371,368,739
157589,13107,Gera Lario,520,517,1037
157691,13110,Grandate,1362,1480,2842
157793,13111,Grandola ed Uniti,665,648,1313
157895,13113,Griante,311,322,633
157997,13114,Guanzate,2870,2935,5805
158099,13118,Inverigo,4510,4676,9186
158201,13119,Laglio,439,479,918
158303,13120,Laino,264,261,525
158405,13121,Lambrugo,1265,1273,2538
158507,13123,Lasnigo,238,235,473
158609,13126,Lezzeno,1001,1049,2050
158711,13128,Limido Comasco,1916,1937,3853
158813,13129,Lipomo,2929,3042,5971
158915,13130,Livo,95,76,171
159017,13131,Locate Varesino,2181,2174,4355
159119,13133,Lomazzo,4875,5113,9988
159221,13134,Longone al Segrino,950,968,1918
159323,13135,Luisago,1348,1376,2724
159425,13136,Lurago d'Erba,2646,2720,5366
159527,13137,Lurago Marinone,1321,1305,2626
159629,13138,Lurate Caccivio,4801,5045,9846
159731,13139,Magreglio,336,340,676
159833,13143,Mariano Comense,12410,12781,25191
159935,13144,Maslianico,1626,1705,3331
160037,13145,Menaggio,1518,1583,3101
160139,13147,Merone,2060,2046,4106
160241,13152,Moltrasio,781,817,1598
160343,13153,Monguzzo,1192,1178,2370
160445,13154,Montano Lucino,2577,2697,5274
160547,13155,Montemezzo,116,108,224
160649,13157,Montorfano,1236,1313,2549
160751,13159,Mozzate,4464,4496,8960
160853,13160,Musso,491,481,972
160955,13161,Nesso,590,622,1212
161057,13163,Novedrate,1457,1396,2853
161159,13165,Olgiate Comasco,5698,5984,11682
161261,13169,Oltrona di San Mamette,1167,1212,2379
161363,13170,Orsenigo,1373,1363,2736
161465,13178,Peglio,91,100,191
161567,13183,Pianello del Lario,506,536,1042
161669,13184,Pigra,117,118,235
161771,13185,Plesio,435,397,832
161873,13186,Pognana Lario,334,347,681
161975,13187,Ponna,120,119,239
162077,13188,Ponte Lambro,2144,2182,4326
162179,13189,Porlezza,2419,2545,4964
162281,13192,Proserpio,463,464,927
162383,13193,Pusiano,666,706,1372
162485,13195,Rezzago,148,147,295
162587,13197,Rodero,686,647,1333
162689,13199,Ronago,840,876,1716
162791,13201,Rovellasca,3839,3965,7804
162893,13202,Rovello Porro,2992,3152,6144
162995,13203,Sala Comacina,236,271,507
163097,13204,San Bartolomeo Val Cavargna,487,509,996
163199,13206,San Fermo della Battaglia,3811,4009,7820
163301,13207,San Nazzaro Val Cavargna,157,141,298
163403,13211,Schignano,456,402,858
163505,13212,Senna Comasco,1605,1577,3182
163607,13216,Sorico,622,641,1263
163709,13217,Sormano,350,296,646
163811,13218,Stazzona,306,292,598
163913,13222,Tavernerio,2805,3000,5805
164015,13223,Torno,560,593,1153
164117,13226,Trezzone,120,111,231
164219,13227,Turate,4727,4780,9507
164321,13228,Uggiate-Trevano,2431,2526,4957
164423,13229,Valbrona,1309,1330,2639
164525,13232,Valmorea,1331,1352,2683
164627,13233,Val Rezzo,84,80,164
164729,13234,Valsolda,753,777,1530
164831,13236,Veleso,119,99,218
164933,13238,Veniano,1516,1537,3053
165035,13239,Vercana,376,371,747
165137,13242,Vertemate con Minoprio,2049,2089,4138
165239,13245,Villa Guardia,3938,4080,8018
165341,13246,Zelbio,108,91,199
165443,13248,San Siro,856,868,1724
165545,13249,Gravedona ed Uniti,2031,2166,4197
165647,13250,Bellagio,1772,1935,3707
165749,13251,Colverde,2665,2751,5416
165851,13252,Tremezzina,2526,2615,5141
165953,13253,Alta Valle Intelvi,1475,1471,2946
166055,13254,Centro Valle Intelvi,1761,1785,3546
166157,13255,Solbiate con Cagno,2293,2365,4658
166259,14001,Albaredo per San Marco,156,135,291
166361,14002,Albosaggia,1514,1497,3011
166463,14003,Andalo Valtellino,281,282,563
166565,14004,Aprica,765,790,1555
166667,14005,Ardenno,1643,1617,3260
166769,14006,Bema,60,63,123
166871,14007,Berbenno di Valtellina,2048,2082,4130
166973,14008,Bianzone,659,656,1315
167075,14009,Bormio,2063,2116,4179
167177,14010,Buglio in Monte,1011,1000,2011
167279,14011,Caiolo,543,551,1094
167381,14012,Campodolcino,467,469,936
167483,14013,Caspoggio,672,702,1374
167585,14014,Castello dell'Acqua,307,306,613
167687,14015,Castione Andevenno,795,803,1598
167789,14016,Cedrasco,209,225,434
167891,14017,Cercino,386,396,782
167993,14018,Chiavenna,3423,3896,7319
168095,14019,Chiesa in Valmalenco,1225,1236,2461
168197,14020,Chiuro,1207,1336,2543
168299,14021,Cino,172,168,340
168401,14022,Civo,582,525,1107
168503,14023,Colorina,696,690,1386
168605,14024,Cosio Valtellino,2820,2708,5528
168707,14025,Dazio,208,240,448
168809,14026,Delebio,1649,1633,3282
168911,14027,Dubino,1830,1856,3686
169013,14028,Faedo Valtellino,275,282,557
169115,14029,Forcola,389,408,797
169217,14030,Fusine,290,292,582
169319,14031,Gerola Alta,106,66,172
169421,14032,Gordona,982,982,1964
169523,14033,Grosio,2104,2321,4425
169625,14034,Grosotto,804,840,1644
169727,14035,Madesimo,268,251,519
169829,14036,Lanzada,677,636,1313
169931,14037,Livigno,3403,3233,6636
170033,14038,Lovero,328,325,653
170135,14039,Mantello,365,382,747
170237,14040,Mazzo di Valtellina,478,511,989
170339,14041,Mello,477,468,945
170441,14043,Mese,892,914,1806
170543,14044,Montagna in Valtellina,1445,1551,2996
170645,14045,Morbegno,5987,6418,12405
170747,14046,Novate Mezzola,920,979,1899
170849,14047,Pedesina,21,17,38
170951,14048,Piantedo,689,701,1390
171053,14049,Piateda,1016,1123,2139
171155,14050,Piuro,955,960,1915
171257,14051,Poggiridenti,920,951,1871
171359,14052,Ponte in Valtellina,1121,1170,2291
171461,14053,Postalesio,343,333,676
171563,14054,Prata Camportaccio,1490,1469,2959
171665,14055,Rasura,154,136,290
171767,14056,Rogolo,286,272,558
171869,14057,Samolaco,1405,1475,2880
171971,14058,San Giacomo Filippo,176,178,354
172073,14059,Sernio,244,245,489
172175,14060,Sondalo,1979,2092,4071
172277,14061,Sondrio,10087,11503,21590
172379,14062,Spriana,41,43,84
172481,14063,Talamona,2317,2359,4676
172583,14064,Tartano,108,91,199
172685,14065,Teglio,2240,2321,4561
172787,14066,Tirano,4346,4665,9011
172889,14067,Torre di Santa Maria,368,381,749
172991,14068,Tovo di Sant'Agata,330,310,640
173093,14069,Traona,1421,1377,2798
173195,14070,Tresivio,975,1013,1988
173297,14071,Valdidentro,2094,2056,4150
173399,14072,Valdisotto,1827,1810,3637
173501,14073,Valfurva,1271,1295,2566
173603,14074,Val Masino,455,426,881
173705,14075,Verceia,550,553,1103
173807,14076,Vervio,113,99,212
173909,14077,Villa di Chiavenna,489,476,965
174011,14078,Villa di Tirano,1456,1490,2946
174113,15002,Abbiategrasso,15835,16775,32610
174215,15005,Albairate,2321,2381,4702
174317,15007,Arconate,3252,3376,6628
174419,15009,Arese,9390,10105,19495
174521,15010,Arluno,5969,6058,12027
174623,15011,Assago,4543,4608,9151
174725,15012,Bareggio,8515,8829,17344
174827,15014,Basiano,1832,1848,3680
174929,15015,Basiglio,3905,4105,8010
175031,15016,Bellinzago Lombardo,1897,1972,3869
175133,15019,Bernate Ticino,1497,1536,3033
175235,15022,Besate,1034,1026,2060
175337,15024,Binasco,3451,3808,7259
175439,15026,Boffalora sopra Ticino,2048,2083,4131
175541,15027,Bollate,17540,19024,36564
175643,15032,Bresso,12659,13641,26300
175745,15035,Bubbiano,1196,1204,2400
175847,15036,Buccinasco,13200,13902,27102
175949,15038,Buscate,2315,2382,4697
176051,15040,Bussero,4077,4362,8439
176153,15041,Busto Garolfo,6882,7009,13891
176255,15042,Calvignasco,605,623,1228
176357,15044,Cambiago,3508,3515,7023
176459,15046,Canegrate,6182,6497,12679
176561,15050,Carpiano,2142,2052,4194
176663,15051,Carugate,7688,7868,15556
176765,15055,Casarile,2008,2066,4074
176867,15058,Casorezzo,2691,2774,5465
176969,15059,Cassano d'Adda,9394,9685,19079
177071,15060,Cassina de' Pecchi,6767,7124,13891
177173,15061,Cassinetta di Lugagnano,918,952,1870
177275,15062,Castano Primo,5562,5645,11207
177377,15070,Cernusco sul Naviglio,16624,17980,34604
177479,15071,Cerro al Lambro,2545,2582,5127
177581,15072,Cerro Maggiore,7422,7815,15237
177683,15074,Cesano Boscone,11705,12265,23970
177785,15076,Cesate,7090,7363,14453
177887,15077,Cinisello Balsamo,36915,38666,75581
177989,15078,Cisliano,2435,2430,4865
178091,15081,Cologno Monzese,23022,24660,47682
178193,15082,Colturano,1052,1031,2083
178295,15085,Corbetta,9075,9345,18420
178397,15086,Cormano,9712,10466,20178
178499,15087,Cornaredo,10037,10507,20544
178601,15093,Corsico,16661,18054,34715
178703,15096,Cuggiono,4082,4189,8271
178805,15097,Cusago,2030,2080,4110
178907,15098,Cusano Milanino,8900,9927,18827
179009,15099,Dairago,3178,3263,6441
179111,15101,Dresano,1487,1556,3043
179213,15103,Gaggiano,4470,4694,9164
179315,15105,Garbagnate Milanese,13322,14063,27385
179417,15106,Gessate,4338,4429,8767
179519,15108,Gorgonzola,10068,10673,20741
179621,15110,Grezzago,1524,1487,3011
179723,15112,Gudo Visconti,804,847,1651
179825,15113,Inveruno,4205,4428,8633
179927,15114,Inzago,5381,5562,10943
180029,15115,Lacchiarella,4395,4617,9012
180131,15116,Lainate,12712,13242,25954
180233,15118,Legnano,29129,31352,60481
180335,15122,Liscate,2066,2023,4089
180437,15125,Locate di Triulzi,5024,5245,10269
180539,15130,Magenta,11678,12324,24002
180641,15131,Magnago,4581,4683,9264
180743,15134,Marcallo con Casone,3043,3115,6158
180845,15136,Masate,1788,1782,3570
180947,15139,Mediglia,6081,6154,12235
181049,15140,Melegnano,8665,9561,18226
181151,15142,Melzo,8739,9514,18253
181253,15144,Mesero,2087,2090,4177
181355,15146,Milano,662551,716138,1378689
181457,15150,Morimondo,538,546,1084
181559,15151,Motta Visconti,3937,4125,8062
181661,15154,Nerviano,8310,8811,17121
181763,15155,Nosate,321,334,655
181865,15157,Novate Milanese,9529,10503,20032
181967,15158,Noviglio,2341,2266,4607
182069,15159,Opera,6666,7254,13920
182171,15164,Ossona,2181,2155,4336
182273,15165,Ozzero,714,735,1449
182375,15166,Paderno Dugnano,22345,23961,46306
182477,15167,Pantigliate,2960,3071,6031
182579,15168,Parabiago,13663,14162,27825
182681,15169,Paullo,5606,5749,11355
182783,15170,Pero,5608,5810,11418
182885,15171,Peschiera Borromeo,11470,12034,23504
182987,15172,Pessano con Bornago,4453,4600,9053
183089,15173,Pieve Emanuele,7964,7896,15860
183191,15175,Pioltello,18478,18524,37002
183293,15176,Pogliano Milanese,4188,4204,8392
183395,15177,Pozzo d'Adda,3140,3019,6159
183497,15178,Pozzuolo Martesana,4190,4394,8584
183599,15179,Pregnana Milanese,3674,3701,7375
183701,15181,Rescaldina,7009,7202,14211
183803,15182,Rho,24490,26112,50602
183905,15183,Robecchetto con Induno,2394,2458,4852
184007,15184,Robecco sul Naviglio,3353,3409,6762
184109,15185,Rodano,2260,2311,4571
184211,15188,Rosate,2916,2930,5846
184313,15189,Rozzano,20564,21866,42430
184415,15191,San Colombano al Lambro,3609,3821,7430
184517,15192,San Donato Milanese,15876,16885,32761
184619,15194,San Giorgio su Legnano,3285,3432,6717
184721,15195,San Giuliano Milanese,19025,19512,38537
184823,15200,Santo Stefano Ticino,2502,2537,5039
184925,15201,San Vittore Olona,4011,4311,8322
185027,15202,San Zenone al Lambro,2244,2204,4448
185129,15204,Sedriano,6109,6137,12246
185231,15205,Segrate,17369,18566,35935
185333,15206,Senago,10530,10851,21381
185435,15209,Sesto San Giovanni,39268,42125,81393
185537,15210,Settala,3661,3665,7326
185639,15211,Settimo Milanese,9749,10345,20094
185741,15213,Solaro,7054,7140,14194
185843,15219,Trezzano Rosa,2582,2592,5174
185945,15220,Trezzano sul Naviglio,10313,10858,21171
186047,15221,Trezzo sull'Adda,5909,6262,12171
186149,15222,Tribiano,1762,1761,3523
186251,15224,Truccazzano,3042,2853,5895
186353,15226,Turbigo,3578,3673,7251
186455,15229,Vanzago,4492,4751,9243
186557,15230,Vaprio d'Adda,4559,4595,9154
186659,15235,Vermezzo,1944,1988,3932
186761,15236,Vernate,1675,1645,3320
186863,15237,Vignate,4590,4721,9311
186965,15242,Vimodrone,8270,8727,16997
187067,15243,Vittuone,4490,4726,9216
187169,15244,Vizzolo Predabissi,1963,2059,4022
187271,15246,Zelo Surrigone,906,967,1873
187373,15247,Zibido San Giacomo,3425,3475,6900
187475,15248,Villa Cortese,3017,3121,6138
187577,15249,Vanzaghello,2583,2748,5331
187679,15250,Baranzate,6216,5767,11983
187781,16001,Adrara San Martino,1168,1061,2229
187883,16002,Adrara San Rocco,427,395,822
187985,16003,Albano Sant'Alessandro,4148,4146,8294
188087,16004,Albino,8756,9049,17805
188189,16005,Almè,2672,2866,5538
188291,16006,Almenno San Bartolomeo,3135,3160,6295
188393,16007,Almenno San Salvatore,2774,2900,5674
188495,16008,Alzano Lombardo,6664,6991,13655
188597,16009,Ambivere,1221,1149,2370
188699,16010,Antegnate,1651,1607,3258
188801,16011,Arcene,2435,2414,4849
188903,16012,Ardesio,1748,1710,3458
189005,16013,Arzago d'Adda,1357,1354,2711
189107,16014,Averara,92,89,181
189209,16015,Aviatico,313,250,563
189311,16016,Azzano San Paolo,3689,3908,7597
189413,16017,Azzone,202,187,389
189515,16018,Bagnatica,2177,2181,4358
189617,16019,Barbata,347,351,698
189719,16020,Bariano,2188,2062,4250
189821,16021,Barzana,1034,950,1984
189923,16022,Bedulita,352,373,725
190025,16023,Berbenno,1167,1218,2385
190127,16024,Bergamo,57501,64138,121639
190229,16025,Berzo San Fermo,712,674,1386
190331,16026,Bianzano,300,304,604
190433,16027,Blello,36,39,75
190535,16028,Bolgare,3186,3123,6309
190637,16029,Boltiere,3159,3017,6176
190739,16030,Bonate Sopra,5007,5078,10085
190841,16031,Bonate Sotto,3318,3365,6683
190943,16032,Borgo di Terzo,603,574,1177
191045,16033,Bossico,486,500,986
191147,16034,Bottanuco,2589,2562,5151
191249,16035,Bracca,341,351,692
191351,16036,Branzi,350,361,711
191453,16037,Brembate,4349,4213,8562
191555,16038,Brembate di Sopra,3909,3943,7852
191657,16040,Brignano Gera d'Adda,2974,3034,6008
191759,16041,Brumano,67,49,116
191861,16042,Brusaporto,2799,2828,5627
191963,16043,Calcinate,3103,2910,6013
192065,16044,Calcio,2774,2601,5375
192167,16046,Calusco d'Adda,4175,4158,8333
192269,16047,Calvenzano,2096,2166,4262
192371,16048,Camerata Cornello,298,308,606
192473,16049,Canonica d'Adda,2279,2159,4438
192575,16050,Capizzone,619,622,1241
192677,16051,Capriate San Gervasio,4091,4067,8158
192779,16052,Caprino Bergamasco,1575,1497,3072
192881,16053,Caravaggio,8010,8249,16259
192983,16055,Carobbio degli Angeli,2371,2367,4738
193085,16056,Carona,142,162,304
193187,16057,Carvico,2309,2386,4695
193289,16058,Casazza,2025,2006,4031
193391,16059,Casirate d'Adda,2047,2070,4117
193493,16060,Casnigo,1657,1594,3251
193595,16061,Cassiglio,48,60,108
193697,16062,Castelli Calepio,5221,5211,10432
193799,16063,Castel Rozzone,1401,1419,2820
193901,16064,Castione della Presolana,1732,1687,3419
194003,16065,Castro,659,640,1299
194105,16066,Cavernago,1313,1326,2639
194207,16067,Cazzano Sant'Andrea,840,821,1661
194309,16068,Cenate Sopra,1282,1263,2545
194411,16069,Cenate Sotto,1951,1924,3875
194513,16070,Cene,2123,2140,4263
194615,16071,Cerete,790,815,1605
194717,16072,Chignolo d'Isola,1797,1677,3474
194819,16073,Chiuduno,3077,3031,6108
194921,16074,Cisano Bergamasco,3129,3189,6318
195023,16075,Ciserano,2904,2656,5560
195125,16076,Cividate al Piano,2612,2564,5176
195227,16077,Clusone,4172,4435,8607
195329,16078,Colere,560,560,1120
195431,16079,Cologno al Serio,5650,5534,11184
195533,16080,Colzate,828,836,1664
195635,16081,Comun Nuovo,2245,2174,4419
195737,16082,Corna Imagna,479,446,925
195839,16083,Cortenuova,962,970,1932
195941,16084,Costa di Mezzate,1705,1686,3391
196043,16085,Costa Valle Imagna,293,283,576
196145,16086,Costa Volpino,4424,4639,9063
196247,16087,Covo,2090,2019,4109
196349,16088,Credaro,1758,1739,3497
196451,16089,Curno,3694,3840,7534
196553,16090,Cusio,126,112,238
196655,16091,Dalmine,11628,11982,23610
196757,16092,Dossena,470,438,908
196859,16093,Endine Gaiano,1737,1698,3435
196961,16094,Entratico,1023,976,1999
197063,16096,Fara Gera d'Adda,3985,4039,8024
197165,16097,Fara Olivana con Sola,678,615,1293
197267,16098,Filago,1561,1571,3132
197369,16099,Fino del Monte,575,555,1130
197471,16100,Fiorano al Serio,1450,1537,2987
197573,16101,Fontanella,2229,2263,4492
197675,16102,Fonteno,291,296,587
197777,16103,Foppolo,106,80,186
197879,16104,Foresto Sparso,1575,1544,3119
197981,16105,Fornovo San Giovanni,1707,1729,3436
198083,16106,Fuipiano Valle Imagna,102,108,210
198185,16107,Gandellino,516,476,992
198287,16108,Gandino,2659,2727,5386
198389,16109,Gandosso,748,709,1457
198491,16110,Gaverina Terme,434,421,855
198593,16111,Gazzaniga,2412,2606,5018
198695,16113,Ghisalba,3089,3084,6173
198797,16114,Gorlago,2607,2565,5172
198899,16115,Gorle,3144,3375,6519
199001,16116,Gorno,781,773,1554
199103,16117,Grassobbio,3277,3183,6460
199205,16118,Gromo,626,575,1201
199307,16119,Grone,465,447,912
199409,16120,Grumello del Monte,3654,3757,7411
199511,16121,Isola di Fondra,89,84,173
199613,16122,Isso,328,326,654
199715,16123,Lallio,1998,2084,4082
199817,16124,Leffe,2214,2207,4421
199919,16125,Lenna,290,308,598
200021,16126,Levate,1889,1876,3765
200123,16127,Locatello,408,404,812
200225,16128,Lovere,2402,2791,5193
200327,16129,Lurano,1441,1406,2847
200429,16130,Luzzana,460,436,896
200531,16131,Madone,2025,1977,4002
200633,16132,Mapello,3473,3352,6825
200735,16133,Martinengo,5368,5279,10647
200837,16134,Mezzoldo,79,82,161
200939,16135,Misano di Gera d'Adda,1487,1504,2991
201041,16136,Moio de' Calvi,107,98,205
201143,16137,Monasterolo del Castello,576,572,1148
201245,16139,Montello,1681,1607,3288
201347,16140,Morengo,1225,1302,2527
201449,16141,Mornico al Serio,1484,1476,2960
201551,16142,Mozzanica,2288,2245,4533
201653,16143,Mozzo,3661,3809,7470
201755,16144,Nembro,5688,5838,11526
201857,16145,Olmo al Brembo,247,250,497
201959,16146,Oltre il Colle,525,483,1008
202061,16147,Oltressenda Alta,78,70,148
202163,16148,Oneta,294,294,588
202265,16149,Onore,448,460,908
202367,16150,Orio al Serio,871,875,1746
202469,16151,Ornica,74,74,148
202571,16152,Osio Sopra,2641,2659,5300
202673,16153,Osio Sotto,6326,6229,12555
202775,16154,Pagazzano,1095,1002,2097
202877,16155,Paladina,2019,2044,4063
202979,16156,Palazzago,2280,2208,4488
203081,16157,Palosco,2875,2881,5756
203183,16158,Parre,1340,1385,2725
203285,16159,Parzanica,184,168,352
203387,16160,Pedrengo,2987,3035,6022
203489,16161,Peia,884,908,1792
203591,16162,Pianico,725,711,1436
203693,16163,Piario,532,533,1065
203795,16164,Piazza Brembana,592,613,1205
203897,16165,Piazzatorre,194,193,387
203999,16166,Piazzolo,41,47,88
204101,16167,Pognano,831,779,1610
204203,16168,Ponte Nossa,881,919,1800
204305,16169,Ponteranica,3409,3412,6821
204407,16170,Ponte San Pietro,5730,5849,11579
204509,16171,Pontida,1695,1682,3377
204611,16172,Pontirolo Nuovo,2535,2464,4999
204713,16173,Pradalunga,2326,2304,4630
204815,16174,Predore,906,951,1857
204917,16175,Premolo,580,532,1112
205019,16176,Presezzo,2429,2514,4943
205121,16177,Pumenengo,855,867,1722
205223,16178,Ranica,2939,3017,5956
205325,16179,Ranzanico,622,607,1229
205427,16180,Riva di Solto,476,446,922
205529,16182,Rogno,1919,1947,3866
205631,16183,Romano di Lombardia,10426,10199,20625
205733,16184,Roncobello,228,201,429
205835,16185,Roncola,380,387,767
205937,16186,Rota d'Imagna,459,455,914
206039,16187,Rovetta,2062,2109,4171
206141,16188,San Giovanni Bianco,2401,2364,4765
206243,16189,San Paolo d'Argon,2924,2900,5824
206345,16190,San Pellegrino Terme,2317,2489,4806
206447,16191,Santa Brigida,272,270,542
206549,16193,Sarnico,3251,3505,6756
206651,16194,Scanzorosciate,4921,5090,10011
206753,16195,Schilpario,563,594,1157
206855,16196,Sedrina,1315,1178,2493
206957,16197,Selvino,1035,1000,2035
207059,16198,Seriate,12491,12894,25385
207161,16199,Serina,1056,1010,2066
207263,16200,Solto Collina,890,904,1794
207365,16201,Songavazzo,362,360,722
207467,16202,Sorisole,4565,4574,9139
207569,16203,Sotto il Monte Giovanni XXIII,2265,2251,4516
207671,16204,Sovere,2610,2714,5324
207773,16205,Spinone al Lago,493,517,1010
207875,16206,Spirano,2901,2901,5802
207977,16207,Stezzano,6509,6725,13234
208079,16208,Strozza,550,518,1068
208181,16209,Suisio,1932,1884,3816
208283,16210,Taleggio,292,253,545
208385,16211,Tavernola Bergamasca,1022,1004,2026
208487,16212,Telgate,2664,2404,5068
208589,16213,Terno d'Isola,4036,4026,8062
208691,16214,Torre Boldone,4222,4555,8777
208793,16215,Torre de' Busi,1079,1047,2126
208895,16216,Torre de' Roveri,1219,1259,2478
208997,16217,Torre Pallavicina,552,530,1082
209099,16218,Trescore Balneario,4861,4904,9765
209201,16219,Treviglio,14653,15439,30092
209303,16220,Treviolo,5368,5522,10890
209405,16221,Ubiale Clanezzo,707,677,1384
209507,16222,Urgnano,5118,4866,9984
209609,16223,Valbondione,511,521,1032
209711,16224,Valbrembo,2124,2195,4319
209813,16225,Valgoglio,306,295,601
209915,16226,Valleve,73,61,134
210017,16227,Valnegra,106,106,212
210119,16229,Valtorta,140,127,267
210221,16230,Vedeseta,117,90,207
210323,16232,Verdellino,3939,3624,7563
210425,16233,Verdello,4058,4012,8070
210527,16234,Vertova,2246,2341,4587
210629,16235,Viadanica,564,573,1137
210731,16236,Vigano San Martino,700,654,1354
210833,16237,Vigolo,294,286,580
210935,16238,Villa d'Adda,2274,2413,4687
211037,16239,Villa d'Almè,3294,3373,6667
211139,16240,Villa di Serio,3379,3401,6780
211241,16241,Villa d'Ogna,904,945,1849
211343,16242,Villongo,4239,3949,8188
211445,16243,Vilminore di Scalve,733,725,1458
211547,16244,Zandobbio,1394,1366,2760
211649,16245,Zanica,4378,4361,8739
211751,16246,Zogno,4351,4532,8883
211853,16247,Costa Serina,463,437,900
211955,16248,Algua,340,328,668
212057,16249,Cornalba,164,136,300
212159,16250,Medolago,1222,1193,2415
212261,16251,Solza,1037,1002,2039
212363,16252,Sant'Omobono Terme,1962,1929,3891
212465,16253,Val Brembilla,2173,2120,4293
212567,17001,Acquafredda,730,798,1528
212669,17002,Adro,3579,3609,7188
212771,17003,Agnosine,869,818,1687
212873,17004,Alfianello,1223,1227,2450
212975,17005,Anfo,267,220,487
213077,17006,Angolo Terme,1187,1175,2362
213179,17007,Artogne,1815,1794,3609
213281,17008,Azzano Mella,1763,1631,3394
213383,17009,Bagnolo Mella,6208,6429,12637
213485,17010,Bagolino,1920,1925,3845
213587,17011,Barbariga,1180,1124,2304
213689,17012,Barghe,617,559,1176
213791,17013,Bassano Bresciano,1197,1131,2328
213893,17014,Bedizzole,6136,6233,12369
213995,17015,Berlingo,1437,1345,2782
214097,17016,Berzo Demo,822,793,1615
214199,17017,Berzo Inferiore,1230,1259,2489
214301,17018,Bienno,1886,1918,3804
214403,17019,Bione,672,690,1362
214505,17020,Borgo San Giacomo,2729,2673,5402
214607,17021,Borgosatollo,4620,4657,9277
214709,17022,Borno,1276,1322,2598
214811,17023,Botticino,5280,5577,10857
214913,17024,Bovegno,1054,1074,2128
215015,17025,Bovezzo,3639,3893,7532
215117,17026,Brandico,864,843,1707
215219,17027,Braone,343,350,693
215321,17028,Breno,2362,2453,4815
215423,17029,Brescia,94314,104222,198536
215525,17030,Brione,369,352,721
215627,17031,Caino,1093,1038,2131
215729,17032,Calcinato,6583,6410,12993
215831,17033,Calvagese della Riviera,1759,1784,3543
215933,17034,Calvisano,4291,4206,8497
216035,17035,Capo di Ponte,1187,1261,2448
216137,17036,Capovalle,169,184,353
216239,17037,Capriano del Colle,2354,2302,4656
216341,17038,Capriolo,4688,4784,9472
216443,17039,Carpenedolo,6579,6517,13096
216545,17040,Castegnato,4250,4282,8532
216647,17041,Castelcovati,3281,3297,6578
216749,17042,Castel Mella,5518,5471,10989
216851,17043,Castenedolo,5729,5767,11496
216953,17044,Casto,871,822,1693
217055,17045,Castrezzato,3640,3712,7352
217157,17046,Cazzago San Martino,5409,5552,10961
217259,17047,Cedegolo,570,580,1150
217361,17048,Cellatica,2368,2513,4881
217463,17049,Cerveno,352,317,669
217565,17050,Ceto,910,954,1864
217667,17051,Cevo,444,413,857
217769,17052,Chiari,9438,9656,19094
217871,17053,Cigole,768,789,1557
217973,17054,Cimbergo,272,268,540
218075,17055,Cividate Camuno,1400,1342,2742
218177,17056,Coccaglio,4351,4313,8664
218279,17057,Collebeato,2259,2384,4643
218381,17058,Collio,1051,1015,2066
218483,17059,Cologne,3748,3816,7564
218585,17060,Comezzano-Cizzago,2061,1939,4000
218687,17061,Concesio,7700,7997,15697
218789,17062,Corte Franca,3577,3579,7156
218891,17063,Corteno Golgi,977,976,1953
218993,17064,Corzano,699,724,1423
219095,17065,Darfo Boario Terme,7781,7910,15691
219197,17066,Dello,2816,2806,5622
219299,17067,Desenzano del Garda,13802,15356,29158
219401,17068,Edolo,2219,2306,4525
219503,17069,Erbusco,4393,4301,8694
219605,17070,Esine,2595,2630,5225
219707,17071,Fiesse,1025,1030,2055
219809,17072,Flero,4411,4510,8921
219911,17073,Gambara,2368,2309,4677
220013,17074,Gardone Riviera,1298,1355,2653
220115,17075,Gardone Val Trompia,5693,5816,11509
220217,17076,Gargnano,1352,1471,2823
220319,17077,Gavardo,6169,6111,12280
220421,17078,Ghedi,9415,9254,18669
220523,17079,Gianico,1054,1078,2132
220625,17080,Gottolengo,2529,2622,5151
220727,17081,Gussago,8181,8558,16739
220829,17082,Idro,924,938,1862
220931,17083,Incudine,180,188,368
221033,17084,Irma,71,57,128
221135,17085,Iseo,4395,4773,9168
221237,17086,Isorella,2080,2026,4106
221339,17087,Lavenone,262,254,516
221441,17088,Leno,7129,7120,14249
221543,17089,Limone sul Garda,571,589,1160
221645,17090,Lodrino,875,798,1673
221747,17091,Lograto,1902,1892,3794
221849,17092,Lonato del Garda,8275,8450,16725
221951,17093,Longhena,301,270,571
222053,17094,Losine,303,306,609
222155,17095,Lozio,198,207,405
222257,17096,Lumezzane,10981,11149,22130
222359,17097,Maclodio,752,720,1472
222461,17098,Magasa,68,55,123
222563,17099,Mairano,1777,1718,3495
222665,17100,Malegno,996,997,1993
222767,17101,Malonno,1545,1605,3150
222869,17102,Manerba del Garda,2669,2701,5370
222971,17103,Manerbio,6392,6769,13161
223073,17104,Marcheno,2145,2144,4289
223175,17105,Marmentino,337,322,659
223277,17106,Marone,1530,1635,3165
223379,17107,Mazzano,6159,6281,12440
223481,17108,Milzano,879,868,1747
223583,17109,Moniga del Garda,1272,1324,2596
223685,17110,Monno,255,280,535
223787,17111,Monte Isola,844,865,1709
223889,17112,Monticelli Brusati,2293,2253,4546
223991,17113,Montichiari,13000,12902,25902
224093,17114,Montirone,2637,2510,5147
224195,17115,Mura,382,392,774
224297,17116,Muscoline,1376,1303,2679
224399,17117,Nave,5322,5468,10790
224501,17118,Niardo,1002,1025,2027
224603,17119,Nuvolento,1939,2055,3994
224705,17120,Nuvolera,2368,2413,4781
224807,17121,Odolo,931,985,1916
224909,17122,Offlaga,2080,1981,4061
225011,17123,Ome,1559,1661,3220
225113,17124,Ono San Pietro,467,496,963
225215,17125,Orzinuovi,6258,6262,12520
225317,17126,Orzivecchi,1242,1214,2456
225419,17127,Ospitaletto,7502,7272,14774
225521,17128,Ossimo,710,734,1444
225623,17129,Padenghe sul Garda,2258,2426,4684
225725,17130,Paderno Franciacorta,1827,1833,3660
225827,17131,Paisco Loveno,94,91,185
225929,17132,Paitone,1086,1039,2125
226031,17133,Palazzolo sull'Oglio,10044,10060,20104
226133,17134,Paratico,2443,2389,4832
226235,17135,Paspardo,315,287,602
226337,17136,Passirano,3478,3590,7068
226439,17137,Pavone del Mella,1407,1363,2770
226541,17138,San Paolo,2267,2238,4505
226643,17139,Pertica Alta,290,253,543
226745,17140,Pertica Bassa,304,305,609
226847,17141,Pezzaze,756,736,1492
226949,17142,Pian Camuno,2382,2359,4741
227051,17143,Pisogne,3955,4008,7963
227153,17144,Polaveno,1263,1247,2510
227255,17145,Polpenazze del Garda,1325,1381,2706
227357,17146,Pompiano,1892,1868,3760
227459,17147,Poncarale,2595,2616,5211
227561,17148,Ponte di Legno,849,912,1761
227663,17149,Pontevico,3347,3791,7138
227765,17150,Pontoglio,3451,3429,6880
227867,17151,Pozzolengo,1769,1754,3523
227969,17152,Pralboino,1482,1441,2923
228071,17153,Preseglie,784,749,1533
228173,17155,Prevalle,3497,3453,6950
228275,17156,Provaglio d'Iseo,3645,3724,7369
228377,17157,Provaglio Val Sabbia,477,438,915
228479,17158,Puegnago sul Garda,1701,1757,3458
228581,17159,Quinzano d'Oglio,3139,3156,6295
228683,17160,Remedello,1685,1697,3382
228785,17161,Rezzato,6677,6874,13551
228887,17162,Roccafranca,2369,2370,4739
228989,17163,Rodengo Saiano,4771,5005,9776
229091,17164,Roè Volciano,2172,2343,4515
229193,17165,Roncadelle,4680,4773,9453
229295,17166,Rovato,9843,9477,19320
229397,17167,Rudiano,2979,2831,5810
229499,17168,Sabbio Chiese,1999,1952,3951
229601,17169,Sale Marasino,1633,1714,3347
229703,17170,Salò,4887,5634,10521
229805,17171,San Felice del Benaco,1668,1759,3427
229907,17172,San Gervasio Bresciano,1299,1329,2628
230009,17173,San Zeno Naviglio,2354,2409,4763
230111,17174,Sarezzo,6562,6727,13289
230213,17175,Saviore dell'Adamello,410,457,867
230315,17176,Sellero,716,714,1430
230417,17177,Seniga,709,710,1419
230519,17178,Serle,1497,1541,3038
230621,17179,Sirmione,3937,4317,8254
230723,17180,Soiano del Lago,948,940,1888
230825,17181,Sonico,632,627,1259
230927,17182,Sulzano,977,966,1943
231029,17183,Tavernole sul Mella,630,621,1251
231131,17184,Temù,553,557,1110
231233,17185,Tignale,582,645,1227
231335,17186,Torbole Casaglia,3304,3231,6535
231437,17187,Toscolano-Maderno,3792,4089,7881
231539,17188,Travagliato,6922,7064,13986
231641,17189,Tremosine sul Garda,1048,1055,2103
231743,17190,Trenzano,2728,2720,5448
231845,17191,Treviso Bresciano,254,265,519
231947,17192,Urago d'Oglio,1927,1824,3751
232049,17193,Vallio Terme,722,719,1441
232151,17194,Valvestino,91,88,179
232253,17195,Verolanuova,4068,4122,8190
232355,17196,Verolavecchia,1910,1848,3758
232457,17197,Vestone,2142,2174,4316
232559,17198,Vezza d'Oglio,699,745,1444
232661,17199,Villa Carcina,5280,5512,10792
232763,17200,Villachiara,693,723,1416
232865,17201,Villanuova sul Clisi,2815,2997,5812
232967,17202,Vione,315,352,667
233069,17203,Visano,1007,971,1978
233171,17204,Vobarno,4120,4022,8142
233273,17205,Zone,521,528,1049
233375,17206,Piancogno,2382,2314,4696
233477,18001,Alagna,419,417,836
233579,18002,Albaredo Arnaboldi,127,106,233
233681,18003,Albonese,262,268,530
233783,18004,Albuzzano,1790,1774,3564
233885,18005,Arena Po,792,764,1556
233987,18006,Badia Pavese,181,178,359
234089,18007,Bagnaria,314,347,661
234191,18008,Barbianello,426,421,847
234293,18009,Bascapè,902,817,1719
234395,18011,Bastida Pancarana,509,484,993
234497,18012,Battuda,348,313,661
234599,18013,Belgioioso,2999,3210,6209
234701,18014,Bereguardo,1322,1342,2664
234803,18015,Borgarello,1344,1360,2704
234905,18016,Borgo Priolo,761,697,1458
235007,18017,Borgoratto Mormorolo,200,217,417
235109,18018,Borgo San Siro,481,494,975
235211,18019,Bornasco,1394,1317,2711
235313,18020,Bosnasco,320,299,619
235415,18021,Brallo di Pregola,297,256,553
235517,18022,Breme,365,383,748
235619,18023,Bressana Bottarone,1708,1766,3474
235721,18024,Broni,4516,5087,9603
235823,18025,Calvignano,55,56,111
235925,18026,Campospinoso,520,575,1095
236027,18027,Candia Lomellina,779,777,1556
236129,18029,Canneto Pavese,675,704,1379
236231,18030,Carbonara al Ticino,724,735,1459
236333,18031,Casanova Lonati,227,210,437
236435,18032,Casatisma,442,439,881
236537,18033,Casei Gerola,1256,1229,2485
236639,18034,Casorate Primo,4406,4373,8779
236741,18035,Cassolnovo,3402,3532,6934
236843,18036,Castana,368,378,746
236945,18037,Casteggio,3182,3556,6738
237047,18038,Castelletto di Branduzzo,567,500,1067
237149,18039,Castello d'Agogna,583,562,1145
237251,18040,Castelnovetto,275,288,563
237353,18041,Cava Manara,3283,3467,6750
237455,18042,Cecima,120,107,227
237557,18043,Ceranova,1151,1088,2239
237659,18044,Ceretto Lomellina,88,100,188
237761,18045,Cergnago,353,369,722
237863,18046,Certosa di Pavia,2775,2769,5544
237965,18047,Cervesina,567,651,1218
238067,18048,Chignolo Po,1982,1988,3970
238169,18049,Cigognola,615,692,1307
238271,18050,Cilavegna,2670,2805,5475
238373,18051,Codevilla,464,515,979
238475,18052,Confienza,782,817,1599
238577,18053,Copiano,837,842,1679
238679,18054,Corana,407,403,810
238781,18057,Corvino San Quirico,483,539,1022
238883,18058,Costa de' Nobili,199,197,396
238985,18059,Cozzo,191,181,372
239087,18060,Cura Carpignano,2408,2531,4939
239189,18061,Dorno,2325,2307,4632
239291,18062,Ferrera Erbognone,571,538,1109
239393,18063,Filighera,410,415,825
239495,18064,Fortunago,189,171,360
239597,18065,Frascarolo,563,614,1177
239699,18066,Galliavola,101,94,195
239801,18067,Gambarana,95,107,202
239903,18068,Gambolò,4886,5010,9896
240005,18069,Garlasco,4759,5025,9784
240107,18071,Gerenzago,699,717,1416
240209,18072,Giussago,2669,2635,5304
240311,18073,Godiasco Salice Terme,1578,1721,3299
240413,18074,Golferenzo,103,90,193
240515,18075,Gravellona Lomellina,1331,1409,2740
240617,18076,Gropello Cairoli,2145,2309,4454
240719,18077,Inverno e Monteleone,755,735,1490
240821,18078,Landriano,3160,3257,6417
240923,18079,Langosco,181,187,368
241025,18080,Lardirago,597,546,1143
241127,18081,Linarolo,1415,1418,2833
241229,18082,Lirio,66,64,130
241331,18083,Lomello,1010,1121,2131
241433,18084,Lungavilla,1172,1279,2451
241535,18085,Magherno,850,855,1705
241637,18086,Marcignago,1247,1254,2501
241739,18087,Marzano,851,817,1668
241841,18088,Mede,3149,3375,6524
241943,18089,Menconico,179,179,358
242045,18090,Mezzana Bigli,544,533,1077
242147,18091,Mezzana Rabattone,224,255,479
242249,18092,Mezzanino,672,679,1351
242351,18093,Miradolo Terme,1869,1864,3733
242453,18094,Montalto Pavese,452,444,896
242555,18095,Montebello della Battaglia,774,789,1563
242657,18096,Montecalvo Versiggia,264,268,532
242759,18097,Montescano,198,226,424
242861,18098,Montesegale,143,136,279
242963,18099,Monticelli Pavese,395,337,732
243065,18100,Montù Beccaria,822,816,1638
243167,18101,Mornico Losana,302,310,612
243269,18102,Mortara,7447,7960,15407
243371,18103,Nicorvo,147,147,294
243473,18104,Olevano di Lomellina,349,361,710
243575,18105,Oliva Gessi,78,84,162
243677,18106,Ottobiano,542,564,1106
243779,18107,Palestro,939,958,1897
243881,18108,Pancarana,154,146,300
243983,18109,Parona,988,917,1905
244085,18110,Pavia,34767,38319,73086
244187,18111,Pietra de' Giorgi,418,417,835
244289,18112,Pieve Albignola,416,444,860
244391,18113,Pieve del Cairo,947,983,1930
244493,18114,Pieve Porto Morone,1357,1303,2660
244595,18115,Pinarolo Po,813,872,1685
244697,18116,Pizzale,348,361,709
244799,18117,Ponte Nizza,391,393,784
244901,18118,Portalbera,719,763,1482
245003,18119,Rea,186,220,406
245105,18120,Redavalle,523,529,1052
245207,18121,Retorbido,751,811,1562
245309,18122,Rivanazzano Terme,2547,2780,5327
245411,18123,Robbio,2830,3030,5860
245513,18124,Robecco Pavese,278,264,542
245615,18125,Rocca de' Giorgi,44,40,84
245717,18126,Rocca Susella,105,113,218
245819,18127,Rognano,325,315,640
245921,18128,Romagnese,343,326,669
246023,18129,Roncaro,794,767,1561
246125,18130,Rosasco,286,288,574
246227,18131,Rovescala,431,452,883
246329,18133,San Cipriano Po,247,231,478
246431,18134,San Damiano al Colle,321,319,640
246533,18135,San Genesio ed Uniti,1879,1991,3870
246635,18136,San Giorgio di Lomellina,534,521,1055
246737,18137,San Martino Siccomario,3135,3304,6439
246839,18138,Sannazzaro de' Burgondi,2694,2720,5414
246941,18139,Santa Cristina e Bissone,996,953,1949
247043,18140,Santa Giuletta,785,832,1617
247145,18141,Sant'Alessio con Vialone,494,476,970
247247,18142,Santa Margherita di Staffora,241,234,475
247349,18143,Santa Maria della Versa,1092,1201,2293
247451,18144,Sant'Angelo Lomellina,393,394,787
247553,18145,San Zenone al Po,287,282,569
247655,18146,Sartirana Lomellina,770,823,1593
247757,18147,Scaldasole,453,456,909
247859,18148,Semiana,104,103,207
247961,18149,Silvano Pietra,335,333,668
248063,18150,Siziano,3019,3109,6128
248165,18151,Sommo,577,581,1158
248267,18152,Spessa,281,289,570
248369,18153,Stradella,5586,5992,11578
248471,18154,Suardi,311,301,612
248573,18155,Torrazza Coste,803,820,1623
248675,18156,Torre Beretti e Castellaro,313,268,581
248777,18157,Torre d'Arese,499,445,944
248879,18158,Torre de' Negri,153,162,315
248981,18159,Torre d'Isola,1178,1247,2425
249083,18160,Torrevecchia Pia,1799,1720,3519
249185,18161,Torricella Verzate,406,427,833
249287,18162,Travacò Siccomario,2128,2252,4380
249389,18163,Trivolzio,1155,1133,2288
249491,18164,Tromello,1852,1918,3770
249593,18165,Trovo,530,488,1018
249695,18166,Val di Nizza,303,322,625
249797,18167,Valeggio,112,105,217
249899,18168,Valle Lomellina,1117,1064,2181
250001,18169,Valle Salimbene,741,759,1500
250103,18171,Varzi,1507,1608,3115
250205,18172,Velezzo Lomellina,51,44,95
250307,18173,Vellezzo Bellini,1673,1658,3331
250409,18174,Verretto,191,181,372
250511,18175,Verrua Po,608,651,1259
250613,18176,Vidigulfo,3217,3291,6508
250715,18177,Vigevano,30772,32654,63426
250817,18178,Villa Biscossi,33,39,72
250919,18179,Villanova d'Ardenghi,383,388,771
251021,18180,Villanterio,1502,1483,2985
251123,18181,Vistarino,779,766,1545
251225,18182,Voghera,18807,20558,39365
251327,18183,Volpara,68,57,125
251429,18184,Zavattarello,507,492,999
251531,18185,Zeccone,823,880,1703
251633,18186,Zeme,522,482,1004
251735,18187,Zenevredo,238,236,474
251837,18188,Zerbo,182,222,404
251939,18189,Zerbolò,891,870,1761
252041,18190,Zinasco,1525,1622,3147
252143,18191,Cornale e Bastida,416,432,848
252245,18192,Corteolona e Genzone,1284,1293,2577
252347,18193,Colli Verdi,548,540,1088
252449,19001,Acquanegra Cremonese,574,599,1173
252551,19002,Agnadello,1978,1940,3918
252653,19003,Annicco,1002,1034,2036
252755,19004,Azzanello,308,316,624
252857,19005,Bagnolo Cremasco,2439,2446,4885
252959,19006,Bonemerse,756,747,1503
253061,19007,Bordolano,298,298,596
253163,19009,Calvatone,618,576,1194
253265,19010,Camisano,628,617,1245
253367,19011,Campagnola Cremasca,330,346,676
253469,19012,Capergnanica,1073,1085,2158
253571,19013,Cappella Cantone,261,285,546
253673,19014,Cappella de' Picenardi,201,209,410
253775,19015,Capralba,1162,1162,2324
253877,19016,Casalbuttano ed Uniti,1850,1960,3810
253979,19017,Casale Cremasco-Vidolasco,962,905,1867
254081,19018,Casaletto Ceredano,579,573,1152
254183,19019,Casaletto di Sopra,283,258,541
254285,19020,Casaletto Vaprio,875,927,1802
254387,19021,Casalmaggiore,7697,7748,15445
254489,19022,Casalmorano,804,818,1622
254591,19023,Casteldidone,296,274,570
254693,19024,Castel Gabbiano,235,210,445
254795,19025,Castelleone,4705,4778,9483
254897,19026,Castelverde,2833,2852,5685
254999,19027,Castelvisconti,145,138,283
255101,19028,Cella Dati,254,246,500
255203,19029,Chieve,1125,1146,2271
255305,19030,Cicognolo,446,481,927
255407,19031,Cingia de' Botti,611,609,1220
255509,19032,Corte de' Cortesi con Cignone,554,528,1082
255611,19033,Corte de' Frati,698,672,1370
255713,19034,Credera Rubbiano,779,793,1572
255815,19035,Crema,16633,17854,34487
255917,19036,Cremona,35034,37646,72680
256019,19037,Cremosano,896,857,1753
256121,19038,Crotta d'Adda,330,320,650
256223,19039,Cumignano sul Naviglio,227,210,437
256325,19040,Derovere,158,148,306
256427,19041,Dovera,1906,1919,3825
256529,19043,Fiesco,594,606,1200
256631,19044,Formigara,524,523,1047
256733,19045,Gabbioneta-Binanuova,434,436,870
256835,19046,Gadesco-Pieve Delmona,979,975,1954
256937,19047,Genivolta,595,580,1175
257039,19048,Gerre de' Caprioli,666,663,1329
257141,19049,Gombito,325,296,621
257243,19050,Grontardo,750,737,1487
257345,19051,Grumello Cremonese ed Uniti,878,870,1748
257447,19052,Gussola,1332,1378,2710
257549,19053,Isola Dovarese,578,590,1168
257651,19054,Izano,1000,988,1988
257753,19055,Madignano,1416,1422,2838
257855,19056,Malagnino,838,881,1719
257957,19057,Martignana di Po,1048,1021,2069
258059,19058,Monte Cremasco,1136,1154,2290
258161,19059,Montodine,1242,1261,2503
258263,19060,Moscazzano,381,372,753
258365,19061,Motta Baluffi,452,441,893
258467,19062,Offanengo,3020,3064,6084
258569,19063,Olmeneta,443,503,946
258671,19064,Ostiano,1431,1449,2880
258773,19065,Paderno Ponchielli,707,700,1407
258875,19066,Palazzo Pignano,1926,1891,3817
258977,19067,Pandino,4476,4557,9033
259079,19068,Persico Dosimo,1684,1705,3389
259181,19069,Pescarolo ed Uniti,757,768,1525
259283,19070,Pessina Cremonese,331,301,632
259385,19072,Pianengo,1277,1242,2519
259487,19073,Pieranica,571,562,1133
259589,19074,Pieve d'Olmi,631,646,1277
259691,19075,Pieve San Giacomo,787,809,1596
259793,19076,Pizzighettone,3121,3311,6432
259895,19077,Pozzaglio ed Uniti,753,717,1470
259997,19078,Quintano,462,451,913
260099,19079,Ricengo,870,861,1731
260201,19080,Ripalta Arpina,503,494,997
260303,19081,Ripalta Cremasca,1700,1697,3397
260405,19082,Ripalta Guerina,284,248,532
260507,19083,Rivarolo del Re ed Uniti,982,958,1940
260609,19084,Rivolta d'Adda,4007,4166,8173
260711,19085,Robecco d'Oglio,1114,1218,2332
260813,19086,Romanengo,1553,1594,3147
260915,19087,Salvirola,580,578,1158
261017,19088,San Bassano,1073,1139,2212
261119,19089,San Daniele Po,673,674,1347
261221,19090,San Giovanni in Croce,941,985,1926
261323,19091,San Martino del Lago,203,205,408
261425,19092,Scandolara Ravara,663,683,1346
261527,19093,Scandolara Ripa d'Oglio,274,251,525
261629,19094,Sergnano,1775,1762,3537
261731,19095,Sesto ed Uniti,1581,1637,3218
261833,19096,Solarolo Rainerio,467,472,939
261935,19097,Soncino,3739,3869,7608
262037,19098,Soresina,4340,4589,8929
262139,19099,Sospiro,1561,1535,3096
262241,19100,Spinadesco,731,745,1476
262343,19101,Spineda,295,316,611
262445,19102,Spino d'Adda,3398,3409,6807
262547,19103,Stagno Lombardo,768,773,1541
262649,19104,Ticengo,211,218,429
262751,19105,Torlino Vimercati,246,240,486
262853,19106,Tornata,251,207,458
262955,19107,Torre de' Picenardi,1042,1039,2081
263057,19108,Torricella del Pizzo,292,292,584
263159,19109,Trescore Cremasco,1403,1426,2829
263261,19110,Trigolo,813,884,1697
263363,19111,Vaiano Cremasco,1852,1845,3697
263465,19112,Vailate,2273,2247,4520
263567,19113,Vescovato,1947,1987,3934
263669,19114,Volongo,251,241,492
263771,19115,Voltido,180,161,341
263873,19116,Piadena Drizzona,1956,2030,3986
263975,20001,Acquanegra sul Chiese,1417,1448,2865
264077,20002,Asola,4899,5157,10056
264179,20003,Bagnolo San Vito,2951,2968,5919
264281,20007,Bozzolo,2032,2132,4164
264383,20008,Canneto sull'Oglio,2199,2170,4369
264485,20010,Casalmoro,1140,1113,2253
264587,20011,Casaloldo,1358,1356,2714
264689,20012,Casalromano,753,760,1513
264791,20013,Castelbelforte,1626,1615,3241
264893,20014,Castel d'Ario,2233,2389,4622
264995,20015,Castel Goffredo,6376,6357,12733
265097,20016,Castellucchio,2632,2612,5244
265199,20017,Castiglione delle Stiviere,11786,11918,23704
265301,20018,Cavriana,1876,1962,3838
265403,20019,Ceresara,1296,1294,2590
265505,20020,Commessaggio,519,566,1085
265607,20021,Curtatone,7215,7706,14921
265709,20022,Dosolo,1686,1727,3413
265811,20024,Gazoldo degli Ippoliti,1534,1446,2980
265913,20025,Gazzuolo,1091,1149,2240
266015,20026,Goito,5044,5147,10191
266117,20027,Gonzaga,4524,4471,8995
266219,20028,Guidizzolo,2977,2995,5972
266321,20029,Magnacavallo,757,752,1509
266423,20030,Mantova,23289,26114,49403
266525,20031,Marcaria,3215,3316,6531
266627,20032,Mariana Mantovana,384,391,775
266729,20033,Marmirolo,3822,3985,7807
266831,20034,Medole,2017,2074,4091
266933,20035,Moglia,2686,2772,5458
267035,20036,Monzambano,2489,2458,4947
267137,20037,Motteggiana,1318,1257,2575
267239,20038,Ostiglia,3220,3387,6607
267341,20039,Pegognaga,3449,3593,7042
267443,20041,Piubega,867,837,1704
267545,20042,Poggio Rusco,3322,3325,6647
267647,20043,Pomponesco,836,869,1705
267749,20044,Ponti sul Mincio,1175,1230,2405
267851,20045,Porto Mantovano,8135,8443,16578
267953,20046,Quingentole,575,597,1172
268055,20047,Quistello,2680,2843,5523
268157,20048,Redondesco,624,640,1264
268259,20050,Rivarolo Mantovano,1259,1273,2532
268361,20051,Rodigo,2608,2675,5283
268463,20052,Roncoferraro,3415,3556,6971
268565,20053,Roverbella,4336,4382,8718
268667,20054,Sabbioneta,2067,2095,4162
268769,20055,San Benedetto Po,3455,3506,6961
268871,20056,San Giacomo delle Segnate,760,773,1533
268973,20057,San Giorgio Bigarello,5875,5998,11873
269075,20058,San Giovanni del Dosso,605,612,1217
269177,20059,San Martino dall'Argine,830,884,1714
269279,20060,Schivenoglia,573,588,1161
269381,20061,Sermide e Felonica,3617,3668,7285
269483,20062,Serravalle a Po,727,748,1475
269585,20063,Solferino,1325,1364,2689
269687,20064,Sustinente,957,1071,2028
269789,20065,Suzzara,10567,10746,21313
269891,20066,Viadana,10056,10098,20154
269993,20068,Villimpenta,1075,1114,2189
270095,20070,Volta Mantovana,3559,3767,7326
270197,20071,Borgo Virgilio,7338,7493,14831
270299,20072,Borgo Mantovano,2656,2873,5529
270401,20073,Borgocarbonara,982,1001,1983
270503,21001,Aldino,848,808,1656
270605,21002,Andriano,528,502,1030
270707,21003,Anterivo,202,196,398
270809,21004,Appiano sulla strada del vino,7404,7530,14934
270911,21005,Avelengo,386,392,778
271013,21006,Badia,1716,1789,3505
271115,21007,Barbiano,879,876,1755
271217,21008,Bolzano,51778,55961,107739
271319,21009,Braies,323,332,655
271421,21010,Brennero,1147,1085,2232
271523,21011,Bressanone,10869,11508,22377
271625,21012,Bronzolo,1399,1409,2808
271727,21013,Brunico,8301,8415,16716
271829,21014,Caines,193,202,395
271931,21015,Caldaro sulla strada del vino,3924,4180,8104
272033,21016,Campo di Trens,1366,1290,2656
272135,21017,Campo Tures,2724,2772,5496
272237,21018,Castelbello-Ciardes,1182,1116,2298
272339,21019,Castelrotto,3458,3397,6855
272441,21020,Cermes,764,763,1527
272543,21021,Chienes,1467,1420,2887
272645,21022,Chiusa,2615,2600,5215
272747,21023,Cornedo all'Isarco,1757,1673,3430
272849,21024,Cortaccia sulla strada del vino,1125,1114,2239
272951,21025,Cortina sulla strada del vino,327,338,665
273053,21026,Corvara in Badia,678,700,1378
273155,21027,Curon Venosta,1220,1169,2389
273257,21028,Dobbiaco,1676,1675,3351
273359,21029,Egna,2631,2753,5384
273461,21030,Falzes,1419,1404,2823
273563,21031,Fiè allo Sciliar,1766,1813,3579
273665,21032,Fortezza,509,491,1000
273767,21033,Funes,1306,1323,2629
273869,21034,Gais,1700,1611,3311
273971,21035,Gargazzone,849,877,1726
274073,21036,Glorenza,468,432,900
274175,21037,Laces,2604,2610,5214
274277,21038,Lagundo,2410,2595,5005
274379,21039,Laion,1350,1365,2715
274481,21040,Laives,8994,9079,18073
274583,21041,Lana,6085,6426,12511
274685,21042,Lasa,2022,2023,4045
274787,21043,Lauregno,186,156,342
274889,21044,Luson,784,790,1574
274991,21045,Magrè sulla strada del vino,617,657,1274
275093,21046,Malles Venosta,2691,2581,5272
275195,21047,Marebbe,1561,1520,3081
275297,21048,Marlengo,1416,1375,2791
275399,21049,Martello,460,381,841
275501,21050,Meltina,878,814,1692
275603,21051,Merano,19677,21185,40862
275705,21052,Monguelfo-Tesido,1442,1472,2914
275807,21053,Montagna,840,861,1701
275909,21054,Moso in Passiria,1107,979,2086
276011,21055,Nalles,1002,1015,2017
276113,21056,Naturno,2960,2909,5869
276215,21057,Naz-Sciaves,1615,1615,3230
276317,21058,Nova Levante,1021,952,1973
276419,21059,Nova Ponente,2007,1930,3937
276521,21060,Ora,1853,1972,3825
276623,21061,Ortisei,2400,2469,4869
276725,21062,Parcines,1867,1916,3783
276827,21063,Perca,780,785,1565
276929,21064,Plaus,374,350,724
277031,21065,Ponte Gardena,111,84,195
277133,21066,Postal,912,960,1872
277235,21067,Prato allo Stelvio,1827,1797,3624
277337,21068,Predoi,284,262,546
277439,21069,Proves,151,114,265
277541,21070,Racines,2299,2198,4497
277643,21071,Rasun-Anterselva,1474,1443,2917
277745,21072,Renon,3962,3993,7955
277847,21073,Rifiano,702,660,1362
277949,21074,Rio di Pusteria,1600,1551,3151
278051,21075,Rodengo,632,608,1240
278153,21076,Salorno,1900,1927,3827
278255,21077,San Candido,1656,1711,3367
278357,21079,San Genesio Atesino,1569,1497,3066
278459,21080,San Leonardo in Passiria,1820,1738,3558
278561,21081,San Lorenzo di Sebato,1947,1938,3885
278663,21082,San Martino in Badia,886,881,1767
278765,21083,San Martino in Passiria,1619,1636,3255
278867,21084,San Pancrazio,789,755,1544
278969,21085,Santa Cristina Valgardena,988,986,1974
279071,21086,Sarentino,3624,3521,7145
279173,21087,Scena,1453,1459,2912
279275,21088,Selva dei Molini,752,680,1432
279377,21089,Selva di Val Gardena,1310,1319,2629
279479,21091,Senales,630,598,1228
279581,21092,Sesto,933,947,1880
279683,21093,Silandro,3059,3156,6215
279785,21094,Sluderno,929,909,1838
279887,21095,Stelvio,595,546,1141
279989,21096,Terento,914,852,1766
280091,21097,Terlano,2216,2257,4473
280193,21098,Termeno sulla strada del vino,1687,1744,3431
280295,21099,Tesimo,975,990,1965
280397,21100,Tires,485,522,1007
280499,21101,Tirolo,1215,1235,2450
280601,21102,Trodena nel parco naturale,506,534,1040
280703,21103,Tubre,470,499,969
280805,21104,Ultimo,1475,1421,2896
280907,21105,Vadena,556,501,1057
281009,21106,Valdaora,1613,1592,3205
281111,21107,Val di Vizze,1564,1529,3093
281213,21108,Valle Aurina,3069,2953,6022
281315,21109,Valle di Casies,1175,1145,2320
281417,21110,Vandoies,1677,1662,3339
281519,21111,Varna,2348,2346,4694
281621,21112,Verano,508,451,959
281723,21113,Villabassa,817,780,1597
281825,21114,Villandro,976,899,1875
281927,21115,Vipiteno,3519,3460,6979
282029,21116,Velturno,1519,1479,2998
282131,21117,La Valle,717,672,1389
282233,21118,Senale-San Felice,392,370,762
282335,22001,Ala,4415,4409,8824
282437,22002,Albiano,761,720,1481
282539,22003,Aldeno,1556,1612,3168
282641,22005,Andalo,551,548,1099
282743,22006,Arco,8675,9153,17828
282845,22007,Avio,1999,2083,4082
282947,22009,Baselga di Pinè,2519,2526,5045
283049,22011,Bedollo,743,738,1481
283151,22013,Besenello,1333,1318,2651
283253,22015,Bieno,207,227,434
283355,22017,Bleggio Superiore,785,755,1540
283457,22018,Bocenago,197,200,397
283559,22021,Bondone,345,322,667
283661,22022,Borgo Valsugana,3408,3545,6953
283763,22025,Brentonico,1999,2003,4002
283865,22026,Bresimo,127,126,253
283967,22027,Brez,377,362,739
284069,22029,Caderzone Terme,341,337,678
284171,22030,Cagnò,168,157,325
284273,22032,Calceranica al Lago,679,679,1358
284375,22033,Caldes,544,556,1100
284477,22034,Caldonazzo,1861,1917,3778
284579,22035,Calliano,968,978,1946
284681,22036,Campitello di Fassa,343,370,713
284783,22037,Campodenno,765,710,1475
284885,22038,Canal San Bovo,713,755,1468
284987,22039,Canazei,898,989,1887
285089,22040,Capriana,298,285,583
285191,22041,Carano,530,560,1090
285293,22042,Carisolo,464,484,948
285395,22043,Carzano,256,271,527
285497,22045,Castel Condino,108,111,219
285599,22046,Castelfondo,301,300,601
285701,22047,Castello-Molina di Fiemme,1163,1162,2325
285803,22048,Castello Tesino,595,592,1187
285905,22049,Castelnuovo,513,523,1036
286007,22050,Cavalese,1973,2139,4112
286109,22051,Cavareno,564,522,1086
286211,22052,Cavedago,285,264,549
286313,22053,Cavedine,1493,1454,2947
286415,22054,Cavizzana,114,124,238
286517,22058,Cimone,360,334,694
286619,22059,Cinte Tesino,167,183,350
286721,22060,Cis,146,158,304
286823,22061,Civezzano,2019,2034,4053
286925,22062,Cles,3378,3642,7020
287027,22063,Cloz,338,319,657
287129,22064,Commezzadura,482,498,980
287231,22068,Croviana,343,332,675
287333,22070,Daiano,341,325,666
287435,22071,Dambel,219,210,429
287537,22074,Denno,600,621,1221
287639,22078,Drena,288,295,583
287741,22079,Dro,2499,2566,5065
287843,22080,Faedo,325,315,640
287945,22081,Fai della Paganella,451,460,911
288047,22083,Fiavè,532,571,1103
288149,22085,Fierozzo,251,221,472
288251,22087,Folgaria,1531,1627,3158
288353,22088,Fondo,711,735,1446
288455,22089,Fornace,680,646,1326
288557,22090,Frassilongo,174,170,344
288659,22091,Garniga Terme,213,203,416
288761,22092,Giovo,1267,1266,2533
288863,22093,Giustino,354,391,745
288965,22095,Grigno,1062,1106,2168
289067,22097,Imer,601,582,1183
289169,22098,Isera,1396,1379,2775
289271,22102,Lavarone,556,606,1162
289373,22103,Lavis,4515,4517,9032
289475,22104,Levico Terme,3966,4128,8094
289577,22106,Livo,409,395,804
289679,22108,Lona-Lases,428,434,862
289781,22109,Luserna,130,131,261
289883,22110,Malé,1061,1145,2206
289985,22111,Malosco,226,217,443
290087,22112,Massimeno,78,61,139
290189,22113,Mazzin,282,297,579
290291,22114,Mezzana,436,444,880
290393,22115,Mezzano,799,798,1597
290495,22116,Mezzocorona,2705,2796,5501
290597,22117,Mezzolombardo,3526,3651,7177
290699,22118,Moena,1308,1336,2644
290801,22120,Molveno,535,578,1113
290903,22123,Mori,4906,5036,9942
291005,22124,Nago-Torbole,1387,1428,2815
291107,22127,Nogaredo,1065,1027,2092
291209,22128,Nomi,642,708,1350
291311,22129,Novaledo,533,560,1093
291413,22130,Ospedaletto,413,382,795
291515,22131,Ossana,395,446,841
291617,22133,Palù del Fersina,87,80,167
291719,22134,Panchià,405,425,830
291821,22135,Ronzo-Chienis,531,465,996
291923,22136,Peio,960,891,1851
292025,22137,Pellizzano,396,388,784
292127,22138,Pelugo,183,202,385
292229,22139,Pergine Valsugana,10466,11005,21471
292331,22142,Pieve Tesino,328,321,649
292433,22143,Pinzolo,1517,1531,3048
292535,22144,Pomarolo,1280,1220,2500
292637,22147,Predazzo,2196,2318,4514
292739,22150,Rabbi,699,654,1353
292841,22152,Revò,644,634,1278
292943,22153,Riva del Garda,8413,9092,17505
293045,22154,Romallo,304,307,611
293147,22155,Romeno,706,690,1396
293249,22156,Roncegno Terme,1431,1499,2930
293351,22157,Ronchi Valsugana,231,215,446
293453,22159,Ronzone,226,202,428
293555,22160,Roverè della Luna,850,830,1680
293657,22161,Rovereto,19042,20930,39972
293759,22162,Ruffrè-Mendola,209,200,409
293861,22163,Rumo,409,397,806
293963,22164,Sagron Mis,87,97,184
294065,22165,Samone,286,261,547
294167,22167,San Michele all'Adige,1606,1617,3223
294269,22168,Sant'Orsola Terme,576,551,1127
294371,22169,Sanzeno,453,472,925
294473,22170,Sarnonico,407,401,808
294575,22171,Scurelle,698,719,1417
294677,22172,Segonzano,700,747,1447
294779,22173,Sfruz,188,182,370
294881,22176,Soraga di Fassa,359,333,692
294983,22177,Sover,426,393,819
295085,22179,Spiazzo,609,655,1264
295187,22180,Spormaggiore,667,605,1272
295289,22181,Sporminore,345,362,707
295391,22182,Stenico,625,549,1174
295493,22183,Storo,2239,2341,4580
295595,22184,Strembo,278,287,565
295697,22188,Telve,939,1015,1954
295799,22189,Telve di Sopra,312,287,599
295901,22190,Tenna,475,514,989
296003,22191,Tenno,974,1042,2016
296105,22193,Terragnolo,367,342,709
296207,22195,Terzolas,313,324,637
296309,22196,Tesero,1469,1496,2965
296411,22199,Tione di Trento,1777,1883,3660
296513,22200,Ton,683,622,1305
296615,22202,Torcegno,342,338,680
296717,22203,Trambileno,739,746,1485
296819,22205,Trento,56982,61306,118288
296921,22209,Valfloriana,235,235,470
297023,22210,Vallarsa,710,660,1370
297125,22211,Varena,420,420,840
297227,22213,Vermiglio,904,929,1833
297329,22216,Vignola-Falesina,96,77,173
297431,22222,Villa Lagarina,1910,1933,3843
297533,22224,Volano,1533,1502,3035
297635,22226,Ziano di Fiemme,856,893,1749
297737,22228,Comano Terme,1465,1498,2963
297839,22229,Ledro,2567,2703,5270
297941,22230,Predaia,3336,3339,6675
298043,22231,San Lorenzo Dorsino,778,793,1571
298145,22232,Valdaone,608,552,1160
298247,22233,Dimaro Folgarida,1025,1115,2140
298349,22234,Pieve di Bono-Prezzo,727,723,1450
298451,22235,Altavalle,804,811,1615
298553,22236,Altopiano della Vigolana,2536,2529,5065
298655,22237,Amblar-Don,264,263,527
298757,22238,Borgo Chiese,1003,1012,2015
298859,22239,Borgo Lares,366,343,709
298961,22240,Castel Ivano,1646,1660,3306
299063,22241,Cembra Lisignago,1187,1146,2333
299165,22242,Contà,690,721,1411
299267,22243,Madruzzo,1463,1445,2908
299369,22244,Porte di Rendena,906,901,1807
299471,22245,Primiero San Martino di Castrozza,2663,2735,5398
299573,22246,Sella Giudicarie,1484,1461,2945
299675,22247,Tre Ville,681,715,1396
299777,22248,Vallelaghi,2528,2537,5065
299879,22249,Ville d'Anaunia,2376,2455,4831
299981,22250,San Giovanni di Fassa,1767,1773,3540
300083,22251,Terre d'Adige,1566,1543,3109
300185,23001,Affi,1145,1217,2362
300287,23002,Albaredo d'Adige,2662,2601,5263
300389,23003,Angiari,1104,1161,2265
300491,23004,Arcole,3123,3222,6345
300593,23005,Badia Calavena,1347,1291,2638
300695,23006,Bardolino,3463,3715,7178
300797,23007,Belfiore,1615,1574,3189
300899,23008,Bevilacqua,851,841,1692
301001,23009,Bonavigo,1031,978,2009
301103,23010,Boschi Sant'Anna,681,710,1391
301205,23011,Bosco Chiesanuova,1864,1693,3557
301307,23012,Bovolone,7958,8100,16058
301409,23013,Brentino Belluno,710,661,1371
301511,23014,Brenzone sul Garda,1143,1321,2464
301613,23015,Bussolengo,9958,10373,20331
301715,23016,Buttapietra,3545,3503,7048
301817,23017,Caldiero,3962,3924,7886
301919,23018,Caprino Veronese,4142,4325,8467
302021,23019,Casaleone,2802,2839,5641
302123,23020,Castagnaro,1822,1865,3687
302225,23021,Castel d'Azzano,5879,6031,11910
302327,23022,Castelnuovo del Garda,6535,6731,13266
302429,23023,Cavaion Veronese,2952,3069,6021
302531,23024,Cazzano di Tramigna,733,761,1494
302633,23025,Cerea,8189,8413,16602
302735,23026,Cerro Veronese,1253,1232,2485
302837,23027,Cologna Veneta,4228,4286,8514
302939,23028,Colognola ai Colli,4391,4417,8808
303041,23029,Concamarise,555,531,1086
303143,23030,Costermano sul Garda,1894,1899,3793
303245,23031,Dolcè,1301,1308,2609
303347,23032,Erbè,963,957,1920
303449,23033,Erbezzo,405,352,757
303551,23034,Ferrara di Monte Baldo,155,120,275
303653,23035,Fumane,2103,2039,4142
303755,23036,Garda,2023,2093,4116
303857,23037,Gazzo Veronese,2603,2711,5314
303959,23038,Grezzana,5567,5365,10932
304061,23039,Illasi,2640,2598,5238
304163,23040,Isola della Scala,5801,5748,11549
304265,23041,Isola Rizza,1620,1622,3242
304367,23042,Lavagno,4246,4249,8495
304469,23043,Lazise,3488,3554,7042
304571,23044,Legnago,12252,13128,25380
304673,23045,Malcesine,1766,1921,3687
304775,23046,Marano di Valpolicella,1579,1599,3178
304877,23047,Mezzane di Sotto,1217,1292,2509
304979,23048,Minerbe,2276,2341,4617
305081,23049,Montecchia di Crosara,2229,2079,4308
305183,23050,Monteforte d'Alpone,4597,4391,8988
305285,23051,Mozzecane,4016,3828,7844
305387,23052,Negrar,8485,8611,17096
305489,23053,Nogara,4196,4289,8485
305591,23054,Nogarole Rocca,1944,1772,3716
305693,23055,Oppeano,5099,4998,10097
305795,23056,Palù,621,623,1244
305897,23057,Pastrengo,1515,1542,3057
305999,23058,Pescantina,8569,8739,17308
306101,23059,Peschiera del Garda,5162,5543,10705
306203,23060,Povegliano Veronese,3614,3703,7317
306305,23061,Pressana,1297,1226,2523
306407,23062,Rivoli Veronese,1090,1106,2196
306509,23063,Roncà,1900,1909,3809
306611,23064,Ronco all'Adige,3048,2971,6019
306713,23065,Roverchiara,1375,1297,2672
306815,23066,Roveredo di Guà,794,807,1601
306917,23067,Roverè Veronese,1062,1037,2099
307019,23068,Salizzole,1927,1865,3792
307121,23069,San Bonifacio,10636,10766,21402
307223,23070,San Giovanni Ilarione,2594,2480,5074
307325,23071,San Giovanni Lupatoto,12412,13020,25432
307427,23072,Sanguinetto,2056,2041,4097
307529,23073,San Martino Buon Albergo,7714,7920,15634
307631,23074,San Mauro di Saline,293,264,557
307733,23075,San Pietro di Morubio,1526,1449,2975
307835,23076,San Pietro in Cariano,6212,6724,12936
307937,23077,Sant'Ambrogio di Valpolicella,5833,6043,11876
308039,23078,Sant'Anna d'Alfaedo,1316,1217,2533
308141,23079,San Zeno di Montagna,717,675,1392
308243,23080,Selva di Progno,471,419,890
308345,23081,Soave,3460,3664,7124
308447,23082,Sommacampagna,7383,7406,14789
308549,23083,Sona,8809,8967,17776
308651,23084,Sorgà,1518,1511,3029
308753,23085,Terrazzo,1064,1124,2188
308855,23086,Torri del Benaco,1490,1564,3054
308957,23087,Tregnago,2415,2475,4890
309059,23088,Trevenzuolo,1431,1349,2780
309161,23089,Valeggio sul Mincio,7696,7868,15564
309263,23090,Velo Veronese,408,356,764
309365,23091,Verona,122292,135701,257993
309467,23092,Veronella,2590,2530,5120
309569,23093,Vestenanova,1294,1253,2547
309671,23094,Vigasio,5152,5095,10247
309773,23095,Villa Bartolomea,2855,2983,5838
309875,23096,Villafranca di Verona,16393,16974,33367
309977,23097,Zevio,7543,7507,15050
310079,23098,Zimella,2458,2422,4880
310181,24001,Agugliaro,723,685,1408
310283,24002,Albettone,1026,1001,2027
310385,24003,Alonte,817,797,1614
310487,24004,Altavilla Vicentina,5971,6050,12021
310589,24005,Altissimo,1152,1072,2224
310691,24006,Arcugnano,3926,3922,7848
310793,24007,Arsiero,1577,1536,3113
310895,24008,Arzignano,12912,12657,25569
310997,24009,Asiago,3089,3364,6453
311099,24010,Asigliano Veneto,437,426,863
311201,24012,Bassano del Grappa,20674,22738,43412
311303,24013,Bolzano Vicentino,3235,3237,6472
311405,24014,Breganze,4195,4415,8610
311507,24015,Brendola,3285,3358,6643
311609,24016,Bressanvido,1589,1583,3172
311711,24017,Brogliano,2021,1961,3982
311813,24018,Caldogno,5464,5806,11270
311915,24019,Caltrano,1227,1282,2509
312017,24020,Calvene,653,661,1314
312119,24021,Camisano Vicentino,5499,5672,11171
312221,24022,Campiglia dei Berici,831,854,1685
312323,24023,Campolongo sul Brenta,417,389,806
312425,24024,Carrè,1801,1809,3610
312527,24025,Cartigliano,1847,1941,3788
312629,24026,Cassola,7301,7535,14836
312731,24027,Castegnero,1468,1437,2905
312833,24028,Castelgomberto,3122,3076,6198
312935,24029,Chiampo,6583,6234,12817
313037,24030,Chiuppano,1241,1253,2494
313139,24031,Cismon del Grappa,452,454,906
313241,24032,Cogollo del Cengio,1602,1612,3214
313343,24033,Conco,1072,1035,2107
313445,24034,Cornedo Vicentino,6038,5958,11996
313547,24035,Costabissara,3807,3874,7681
313649,24036,Creazzo,5522,5840,11362
313751,24037,Crespadoro,711,605,1316
313853,24038,Dueville,6787,7073,13860
313955,24039,Enego,818,796,1614
314057,24040,Fara Vicentino,1877,1900,3777
314159,24041,Foza,369,321,690
314261,24042,Gallio,1164,1204,2368
314363,24043,Gambellara,1693,1721,3414
314465,24044,Gambugliano,441,389,830
314567,24046,Grisignano di Zocco,2142,2132,4274
314669,24047,Grumolo delle Abbadesse,1901,1866,3767
314771,24048,Isola Vicentina,5027,5215,10242
314873,24049,Laghi,60,71,131
314975,24050,Lastebasse,96,97,193
315077,24051,Longare,2816,2793,5609
315179,24052,Lonigo,8286,8225,16511
315281,24053,Lugo di Vicenza,1810,1826,3636
315383,24054,Lusiana,1285,1278,2563
315485,24055,Malo,7455,7461,14916
315587,24056,Marano Vicentino,4769,4744,9513
315689,24057,Marostica,6957,7081,14038
315791,24058,Mason Vicentino,1682,1795,3477
315893,24059,Molvena,1271,1299,2570
315995,24060,Montebello Vicentino,3272,3240,6512
316097,24061,Montecchio Maggiore,11889,11570,23459
316199,24062,Montecchio Precalcino,2501,2542,5043
316301,24063,Monte di Malo,1409,1416,2825
316403,24064,Montegalda,1699,1734,3433
316505,24065,Montegaldella,908,881,1789
316607,24066,Monteviale,1428,1407,2835
316709,24067,Monticello Conte Otto,4440,4580,9020
316811,24068,Montorso Vicentino,1572,1507,3079
316913,24070,Mussolente,3838,3771,7609
317015,24071,Nanto,1594,1514,3108
317117,24072,Nogarole Vicentino,613,598,1211
317219,24073,Nove,2426,2523,4949
317321,24074,Noventa Vicentina,4461,4494,8955
317423,24075,Orgiano,1520,1535,3055
317525,24076,Pedemonte,344,394,738
317627,24077,Pianezze,1041,1110,2151
317729,24078,Piovene Rocchette,4077,4242,8319
317831,24079,Pojana Maggiore,2164,2152,4316
317933,24080,Posina,283,276,559
318035,24081,Pove del Grappa,1528,1620,3148
318137,24082,Pozzoleone,1456,1337,2793
318239,24083,Quinto Vicentino,2875,2926,5801
318341,24084,Recoaro Terme,3083,3185,6268
318443,24085,Roana,2134,2087,4221
318545,24086,Romano d'Ezzelino,7077,7213,14290
318647,24087,Rosà,7159,7401,14560
318749,24088,Rossano Veneto,4009,4074,8083
318851,24089,Rotzo,317,337,654
318953,24090,Salcedo,520,514,1034
319055,24091,Sandrigo,4157,4301,8458
319157,24093,San Nazario,858,786,1644
319259,24094,San Pietro Mussolino,803,786,1589
319361,24095,Santorso,2846,2888,5734
319463,24096,San Vito di Leguzzano,1750,1840,3590
319565,24097,Sarcedo,2614,2664,5278
319667,24098,Sarego,3449,3291,6740
319769,24099,Schiavon,1320,1295,2615
319871,24100,Schio,19135,20027,39162
319973,24101,Solagna,930,966,1896
320075,24102,Sossano,2172,2121,4293
320177,24103,Sovizzo,3785,3866,7651
320279,24104,Tezze sul Brenta,6407,6440,12847
320381,24105,Thiene,11822,12612,24434
320483,24106,Tonezza del Cimone,267,257,524
320585,24107,Torrebelvicino,2944,2940,5884
320687,24108,Torri di Quartesolo,5801,5910,11711
320789,24110,Trissino,4374,4375,8749
320891,24111,Valdagno,12585,13463,26048
320993,24112,Valdastico,612,654,1266
321095,24113,Valli del Pasubio,1580,1534,3114
321197,24114,Valstagna,886,859,1745
321299,24115,Velo d'Astico,1144,1187,2331
321401,24116,Vicenza,52561,58229,110790
321503,24117,Villaga,944,971,1915
321605,24118,Villaverla,3095,3041,6136
321707,24119,Zanè,3261,3374,6635
321809,24120,Zermeghedo,707,674,1381
321911,24121,Zovencedo,410,361,771
322013,24122,Zugliano,3289,3464,6753
322115,24123,Val Liona,1589,1494,3083
322217,24124,Barbarano Mossano,3150,3275,6425
322319,25001,Agordo,1938,2179,4117
322421,25002,Alano di Piave,1352,1416,2768
322523,25003,Alleghe,574,618,1192
322625,25004,Arsiè,1098,1152,2250
322727,25005,Auronzo di Cadore,1584,1695,3279
322829,25006,Belluno,17040,18793,35833
322931,25007,Borca di Cadore,387,406,793
323033,25008,Calalzo di Cadore,955,1013,1968
323135,25010,Cencenighe Agordino,613,659,1272
323237,25011,Cesiomaggiore,1975,1983,3958
323339,25012,Chies d'Alpago,653,660,1313
323441,25013,Cibiana di Cadore,178,203,381
323543,25014,Colle Santa Lucia,183,177,360
323645,25015,Comelico Superiore,1056,1095,2151
323747,25016,Cortina d'Ampezzo,2700,3120,5820
323849,25017,Danta di Cadore,224,220,444
323951,25018,Domegge di Cadore,1117,1220,2337
324053,25019,Falcade,897,969,1866
324155,25021,Feltre,9881,10679,20560
324257,25022,Fonzaso,1587,1576,3163
324359,25023,Canale d'Agordo,530,585,1115
324461,25025,Gosaldo,305,277,582
324563,25026,Lamon,1373,1435,2808
324665,25027,La Valle Agordina,532,538,1070
324767,25028,Lentiai,1451,1486,2937
324869,25029,Limana,2621,2687,5308
324971,25030,Livinallongo del Col di Lana,609,683,1292
325073,25032,Lorenzago di Cadore,277,281,558
325175,25033,Lozzo di Cadore,643,697,1340
325277,25034,Mel,2924,3008,5932
325379,25035,Ospitale di Cadore,142,131,273
325481,25036,Pedavena,2133,2263,4396
325583,25037,Perarolo di Cadore,176,176,352
325685,25039,Pieve di Cadore,1801,1952,3753
325787,25040,Ponte nelle Alpi,4043,4189,8232
325889,25043,Rivamonte Agordino,314,298,612
325991,25044,Rocca Pietore,587,616,1203
326093,25045,San Gregorio nelle Alpi,792,805,1597
326195,25046,San Nicolò di Comelico,192,196,388
326297,25047,San Pietro di Cadore,802,805,1607
326399,25048,Santa Giustina,3295,3491,6786
326501,25049,San Tomaso Agordino,304,306,610
326603,25050,Santo Stefano di Cadore,1224,1278,2502
326705,25051,San Vito di Cadore,920,974,1894
326807,25053,Sedico,4962,5236,10198
326909,25054,Selva di Cadore,244,262,506
327011,25055,Seren del Grappa,1231,1212,2443
327113,25056,Sospirolo,1551,1584,3135
327215,25057,Soverzene,181,194,375
327317,25058,Sovramonte,684,716,1400
327419,25059,Taibon Agordino,853,892,1745
327521,25060,Tambre,660,666,1326
327623,25061,Trichiana,2377,2453,4830
327725,25062,Vallada Agordina,234,251,485
327827,25063,Valle di Cadore,896,972,1868
327929,25065,Vigo di Cadore,678,720,1398
328031,25066,Vodo Cadore,417,437,854
328133,25067,Voltago Agordino,426,425,851
328235,25069,Zoppè di Cadore,105,107,212
328337,25070,Quero Vas,1581,1562,3143
328439,25071,Longarone,2509,2692,5201
328541,25072,Alpago,3394,3458,6852
328643,25073,Val di Zoldo,1554,1602,3156
328745,26001,Altivole,3453,3522,6975
328847,26002,Arcade,2268,2264,4532
328949,26003,Asolo,4533,4575,9108
329051,26004,Borso del Grappa,2978,2973,5951
329153,26005,Breda di Piave,3912,3896,7808
329255,26006,Caerano di San Marco,3904,4048,7952
329357,26007,Cappella Maggiore,2338,2411,4749
329459,26008,Carbonera,5509,5747,11256
329561,26009,Casale sul Sile,6429,6651,13080
329663,26010,Casier,5574,5727,11301
329765,26011,Castelcucco,1159,1129,2288
329867,26012,Castelfranco Veneto,16241,17266,33507
329969,26013,Castello di Godego,3588,3610,7198
330071,26014,Cavaso del Tomba,1402,1483,2885
330173,26015,Cessalto,1900,1961,3861
330275,26016,Chiarano,1880,1820,3700
330377,26017,Cimadolmo,1695,1714,3409
330479,26018,Cison di Valmarino,1298,1334,2632
330581,26019,Codognè,2700,2627,5327
330683,26020,Colle Umberto,2489,2582,5071
330785,26021,Conegliano,16806,18425,35231
330887,26022,Cordignano,3420,3539,6959
330989,26023,Cornuda,3088,3197,6285
331091,26024,Crespano del Grappa,2182,2359,4541
331193,26025,Crocetta del Montello,3018,3080,6098
331295,26026,Farra di Soligo,4286,4418,8704
331397,26027,Follina,1819,1965,3784
331499,26028,Fontanelle,2837,2902,5739
331601,26029,Fonte,2951,2931,5882
331703,26030,Fregona,1444,1475,2919
331805,26031,Gaiarine,2988,3053,6041
331907,26032,Giavera del Montello,2621,2616,5237
332009,26033,Godega di Sant'Urbano,3013,3033,6046
332111,26034,Gorgo al Monticano,2085,2030,4115
332213,26035,Istrana,4730,4450,9180
332315,26036,Loria,4810,4553,9363
332417,26037,Mansuè,2590,2474,5064
332519,26038,Mareno di Piave,4782,4856,9638
332621,26039,Maser,2546,2572,5118
332723,26040,Maserada sul Piave,4622,4734,9356
332825,26041,Meduna di Livenza,1435,1529,2964
332927,26042,Miane,1601,1651,3252
333029,26043,Mogliano Veneto,13604,14164,27768
333131,26044,Monastier di Treviso,2176,2208,4384
333233,26045,Monfumo,667,657,1324
333335,26046,Montebelluna,15287,16093,31380
333437,26047,Morgano,2236,2225,4461
333539,26048,Moriago della Battaglia,1420,1416,2836
333641,26049,Motta di Livenza,5274,5501,10775
333743,26050,Nervesa della Battaglia,3273,3343,6616
333845,26051,Oderzo,10004,10655,20659
333947,26052,Ormelle,2259,2266,4525
334049,26053,Orsago,1899,1962,3861
334151,26054,Paderno del Grappa,1112,1093,2205
334253,26055,Paese,10948,11120,22068
334355,26056,Pederobba,3664,3689,7353
334457,26057,Pieve di Soligo,5918,6129,12047
334559,26058,Ponte di Piave,4215,4126,8341
334661,26059,Ponzano Veneto,6291,6591,12882
334763,26060,Portobuffolè,385,376,761
334865,26061,Possagno,1108,1116,2224
334967,26062,Povegliano,2626,2604,5230
335069,26063,Preganziol,8261,8630,16891
335171,26064,Quinto di Treviso,4905,5052,9957
335273,26065,Refrontolo,845,857,1702
335375,26066,Resana,4800,4722,9522
335477,26067,Revine Lago,1073,1077,2150
335579,26068,Riese Pio X,5505,5495,11000
335681,26069,Roncade,7219,7349,14568
335783,26070,Salgareda,3394,3340,6734
335885,26071,San Biagio di Callalta,6535,6511,13046
335987,26072,San Fior,3465,3510,6975
336089,26073,San Pietro di Feletto,2516,2703,5219
336191,26074,San Polo di Piave,2526,2444,4970
336293,26075,Santa Lucia di Piave,4570,4597,9167
336395,26076,San Vendemiano,4930,5031,9961
336497,26077,San Zenone degli Ezzelini,3800,3592,7392
336599,26078,Sarmede,1539,1520,3059
336701,26079,Segusino,940,937,1877
336803,26080,Sernaglia della Battaglia,3066,3125,6191
336905,26081,Silea,4938,5316,10254
337007,26082,Spresiano,6024,6199,12223
337109,26083,Susegana,5848,5932,11780
337211,26084,Tarzo,2097,2239,4336
337313,26085,Trevignano,5390,5426,10816
337415,26086,Treviso,40557,44442,84999
337517,26087,Valdobbiadene,4981,5290,10271
337619,26088,Vazzola,3474,3491,6965
337721,26089,Vedelago,8430,8373,16803
337823,26090,Vidor,1816,1878,3694
337925,26091,Villorba,8701,9198,17899
338027,26092,Vittorio Veneto,13561,14587,28148
338129,26093,Volpago del Montello,5035,5159,10194
338231,26094,Zenson di Piave,879,932,1811
338333,26095,Zero Branco,5697,5729,11426
338435,27001,Annone Veneto,1929,1920,3849
338537,27002,Campagna Lupia,3562,3692,7254
338639,27003,Campolongo Maggiore,5308,5372,10680
338741,27004,Camponogara,6477,6668,13145
338843,27005,Caorle,5570,5953,11523
338945,27006,Cavarzere,6652,6985,13637
339047,27007,Ceggia,2995,3115,6110
339149,27008,Chioggia,24415,24844,49259
339251,27009,Cinto Caomaggiore,1577,1655,3232
339353,27010,Cona,1543,1463,3006
339455,27011,Concordia Sagittaria,5006,5377,10383
339557,27012,Dolo,7289,7815,15104
339659,27013,Eraclea,6020,6186,12206
339761,27014,Fiesso d'Artico,4197,4240,8437
339863,27015,Fossalta di Piave,2017,2149,4166
339965,27016,Fossalta di Portogruaro,2997,3146,6143
340067,27017,Fossò,3460,3574,7034
340169,27018,Gruaro,1330,1435,2765
340271,27019,Jesolo,12886,13677,26563
340373,27020,Marcon,8712,8801,17513
340475,27021,Martellago,10526,11033,21559
340577,27022,Meolo,3196,3157,6353
340679,27023,Mira,18788,19633,38421
340781,27024,Mirano,13229,14121,27350
340883,27025,Musile di Piave,5689,5816,11505
340985,27026,Noale,7777,8324,16101
341087,27027,Noventa di Piave,3408,3562,6970
341189,27028,Pianiga,6135,6234,12369
341291,27029,Portogruaro,11948,12961,24909
341393,27030,Pramaggiore,2331,2333,4664
341495,27031,Quarto d'Altino,3956,4208,8164
341597,27032,Salzano,6430,6570,13000
341699,27033,San Donà di Piave,20098,21745,41843
341801,27034,San Michele al Tagliamento,5734,6129,11863
341903,27035,Santa Maria di Sala,8808,8789,17597
342005,27036,San Stino di Livenza,6398,6530,12928
342107,27037,Scorzè,9402,9559,18961
342209,27038,Spinea,13402,14582,27984
342311,27039,Stra,3714,3958,7672
342413,27040,Teglio Veneto,1145,1146,2291
342515,27041,Torre di Mosto,2364,2412,4776
342617,27042,Venezia,124088,136432,260520
342719,27043,Vigonovo,4961,5042,10003
342821,27044,Cavallino-Treporti,6616,6910,13526
342923,28001,Abano Terme,9576,10689,20265
343025,28002,Agna,1590,1640,3230
343127,28003,Albignasego,12708,13570,26278
343229,28004,Anguillara Veneta,2105,2184,4289
343331,28005,Arquà Petrarca,925,900,1825
343433,28006,Arre,1069,1058,2127
343535,28007,Arzergrande,2406,2405,4811
343637,28008,Bagnoli di Sopra,1750,1788,3538
343739,28009,Baone,1541,1519,3060
343841,28010,Barbona,316,312,628
343943,28011,Battaglia Terme,1902,1983,3885
344045,28012,Boara Pisani,1217,1231,2448
344147,28013,Borgoricco,4456,4380,8836
344249,28014,Bovolenta,1737,1734,3471
344351,28015,Brugine,3521,3593,7114
344453,28016,Cadoneghe,7836,8351,16187
344555,28017,Campodarsego,7289,7520,14809
344657,28018,Campodoro,1338,1337,2675
344759,28019,Camposampiero,5951,6066,12017
344861,28020,Campo San Martino,2870,2877,5747
344963,28021,Candiana,1135,1150,2285
345065,28022,Carceri,759,771,1530
345167,28023,Carmignano di Brenta,3788,3813,7601
345269,28026,Cartura,2278,2373,4651
345371,28027,Casale di Scodosia,2422,2424,4846
345473,28028,Casalserugo,2625,2767,5392
345575,28029,Castelbaldo,728,773,1501
345677,28030,Cervarese Santa Croce,2856,2852,5708
345779,28031,Cinto Euganeo,990,972,1962
345881,28032,Cittadella,9840,10321,20161
345983,28033,Codevigo,3287,3172,6459
346085,28034,Conselve,4968,5290,10258
346187,28035,Correzzola,2598,2555,5153
346289,28036,Curtarolo,3605,3637,7242
346391,28037,Este,7730,8550,16280
346493,28038,Fontaniva,3983,4028,8011
346595,28039,Galliera Veneta,3501,3640,7141
346697,28040,Galzignano Terme,2167,2149,4316
346799,28041,Gazzo,2138,2151,4289
346901,28042,Grantorto,2314,2281,4595
347003,28043,Granze,980,1039,2019
347105,28044,Legnaro,4501,4513,9014
347207,28045,Limena,3958,4024,7982
347309,28046,Loreggia,3912,3831,7743
347411,28047,Lozzo Atestino,1538,1526,3064
347513,28048,Maserà di Padova,4536,4594,9130
347615,28049,Masi,854,910,1764
347717,28050,Massanzago,3077,3004,6081
347819,28052,Megliadino San Vitale,917,943,1860
347921,28053,Merlara,1273,1339,2612
348023,28054,Mestrino,5670,5898,11568
348125,28055,Monselice,8468,9033,17501
348227,28056,Montagnana,4360,4664,9024
348329,28057,Montegrotto Terme,5580,5993,11573
348431,28058,Noventa Padovana,5650,5827,11477
348533,28059,Ospedaletto Euganeo,2787,2842,5629
348635,28060,Padova,99747,111165,210912
348737,28061,Pernumia,1921,1911,3832
348839,28062,Piacenza d'Adige,629,647,1276
348941,28063,Piazzola sul Brenta,5452,5671,11123
349043,28064,Piombino Dese,4842,4728,9570
349145,28065,Piove di Sacco,9689,10397,20086
349247,28066,Polverara,1624,1690,3314
349349,28067,Ponso,1228,1169,2397
349451,28068,Pontelongo,1833,1859,3692
349553,28069,Ponte San Nicolò,6513,6989,13502
349655,28070,Pozzonovo,1737,1795,3532
349757,28071,Rovolon,2513,2440,4953
349859,28072,Rubano,8024,8520,16544
349961,28073,Saccolongo,2431,2447,4878
350063,28075,San Giorgio delle Pertiche,5071,5103,10174
350165,28076,San Giorgio in Bosco,3192,3165,6357
350267,28077,San Martino di Lupari,6505,6608,13113
350369,28078,San Pietro in Gu,2181,2277,4458
350471,28079,San Pietro Viminario,1522,1506,3028
350573,28080,Santa Giustina in Colle,3631,3659,7290
350675,28082,Sant'Angelo di Piove di Sacco,3568,3668,7236
350777,28083,Sant'Elena,1244,1291,2535
350879,28084,Sant'Urbano,966,1004,1970
350981,28085,Saonara,5149,5294,10443
351083,28086,Selvazzano Dentro,11119,11845,22964
351185,28087,Solesino,3436,3559,6995
351287,28088,Stanghella,2011,2107,4118
351389,28089,Teolo,4432,4621,9053
351491,28090,Terrassa Padovana,1335,1305,2640
351593,28091,Tombolo,4142,4250,8392
351695,28092,Torreglia,3045,3095,6140
351797,28093,Trebaseleghe,6476,6497,12973
351899,28094,Tribano,2204,2139,4343
352001,28095,Urbana,1028,1060,2088
352103,28096,Veggiano,2389,2379,4768
352205,28097,Vescovana,889,902,1791
352307,28098,Vighizzolo d'Este,476,445,921
352409,28099,Vigodarzere,6423,6634,13057
352511,28100,Vigonza,11216,11819,23035
352613,28101,Villa del Conte,2828,2754,5582
352715,28102,Villa Estense,1105,1092,2197
352817,28103,Villafranca Padovana,5123,5356,10479
352919,28104,Villanova di Camposampiero,3030,3106,6136
353021,28105,Vo',1620,1684,3304
353123,28106,Due Carrare,4544,4513,9057
353225,28107,Borgo Veneto,3445,3553,6998
353327,29001,Adria,9345,10002,19347
353429,29002,Ariano nel Polesine,2023,2179,4202
353531,29003,Arquà Polesine,1304,1350,2654
353633,29004,Badia Polesine,4980,5283,10263
353735,29005,Bagnolo di Po,601,603,1204
353837,29006,Bergantino,1223,1303,2526
353939,29007,Bosaro,722,761,1483
354041,29008,Calto,346,362,708
354143,29009,Canaro,1306,1394,2700
354245,29010,Canda,454,447,901
354347,29011,Castelguglielmo,784,755,1539
354449,29012,Castelmassa,1927,2152,4079
354551,29013,Castelnovo Bariano,1321,1368,2689
354653,29014,Ceneselli,801,811,1612
354755,29015,Ceregnano,1704,1829,3533
354857,29017,Corbola,1112,1229,2341
354959,29018,Costa di Rovigo,1182,1314,2496
355061,29019,Crespino,845,938,1783
355163,29021,Ficarolo,1163,1193,2356
355265,29022,Fiesso Umbertiano,1932,2029,3961
355367,29023,Frassinelle Polesine,725,693,1418
355469,29024,Fratta Polesine,1201,1378,2579
355571,29025,Gaiba,480,512,992
355673,29026,Gavello,756,759,1515
355775,29027,Giacciano con Baruchella,1060,1033,2093
355877,29028,Guarda Veneta,540,585,1125
355979,29029,Lendinara,5644,5990,11634
356081,29030,Loreo,1704,1754,3458
356183,29031,Lusia,1703,1734,3437
356285,29032,Melara,839,902,1741
356387,29033,Occhiobello,5841,6160,12001
356489,29034,Papozze,695,738,1433
356591,29035,Pettorazza Grimani,794,746,1540
356693,29036,Pincara,565,581,1146
356795,29037,Polesella,1923,1969,3892
356897,29038,Pontecchio Polesine,1128,1087,2215
356999,29039,Porto Tolle,4694,4852,9546
357101,29040,Rosolina,3192,3191,6383
357203,29041,Rovigo,24403,26701,51104
357305,29042,Salara,530,587,1117
357407,29043,San Bellino,548,534,1082
357509,29044,San Martino di Venezze,1877,1994,3871
357611,29045,Stienta,1578,1613,3191
357713,29046,Taglio di Po,4055,4140,8195
357815,29047,Trecenta,1270,1373,2643
357917,29048,Villadose,2423,2509,4932
358019,29049,Villamarzana,588,580,1168
358121,29050,Villanova del Ghebbo,995,988,1983
358223,29051,Villanova Marchesana,455,454,909
358325,29052,Porto Viro,6897,7320,14217
358427,30001,Aiello del Friuli,1083,1140,2223
358529,30002,Amaro,417,437,854
358631,30003,Ampezzo,494,477,971
358733,30004,Aquileia,1586,1682,3268
358835,30005,Arta Terme,1033,1043,2076
358937,30006,Artegna,1387,1484,2871
359039,30007,Attimis,830,891,1721
359141,30008,Bagnaria Arsa,1710,1769,3479
359243,30009,Basiliano,2610,2686,5296
359345,30010,Bertiolo,1164,1229,2393
359447,30011,Bicinicco,904,930,1834
359549,30012,Bordano,357,369,726
359651,30013,Buja,3109,3345,6454
359753,30014,Buttrio,1951,1996,3947
359855,30015,Camino al Tagliamento,799,808,1607
359957,30016,Campoformido,3841,4032,7873
360059,30018,Carlino,1370,1434,2804
360161,30019,Cassacco,1430,1455,2885
360263,30020,Castions di Strada,1835,1916,3751
360365,30021,Cavazzo Carnico,485,513,998
360467,30022,Cercivento,343,336,679
360569,30023,Cervignano del Friuli,6842,6969,13811
360671,30024,Chiopris-Viscone,302,342,644
360773,30025,Chiusaforte,325,294,619
360875,30026,Cividale del Friuli,5282,5819,11101
360977,30027,Codroipo,7994,8174,16168
361079,30028,Colloredo di Monte Albano,1054,1124,2178
361181,30029,Comeglians,240,236,476
361283,30030,Corno di Rosazzo,1571,1584,3155
361385,30031,Coseano,1050,1117,2167
361487,30032,Dignano,1088,1196,2284
361589,30033,Dogna,88,77,165
361691,30034,Drenchia,51,53,104
361793,30035,Enemonzo,648,662,1310
361895,30036,Faedis,1417,1443,2860
361997,30037,Fagagna,3051,3234,6285
362099,30039,Flaibano,548,560,1108
362201,30040,Forni Avoltri,284,279,563
362303,30041,Forni di Sopra,467,454,921
362405,30042,Forni di Sotto,291,287,578
362507,30043,Gemona del Friuli,5225,5626,10851
362609,30044,Gonars,2292,2388,4680
362711,30045,Grimacco,155,171,326
362813,30046,Latisana,6478,6975,13453
362915,30047,Lauco,347,360,707
363017,30048,Lestizza,1858,1898,3756
363119,30049,Lignano Sabbiadoro,3369,3516,6885
363221,30051,Lusevera,302,315,617
363323,30052,Magnano in Riviera,1133,1200,2333
363425,30053,Majano,2867,3053,5920
363527,30054,Malborghetto Valbruna,473,450,923
363629,30055,Manzano,3123,3319,6442
363731,30056,Marano Lagunare,901,895,1796
363833,30057,Martignacco,3304,3534,6838
363935,30058,Mereto di Tomba,1321,1299,2620
364037,30059,Moggio Udinese,821,857,1678
364139,30060,Moimacco,845,831,1676
364241,30061,Montenars,260,245,505
364343,30062,Mortegliano,2342,2596,4938
364445,30063,Moruzzo,1228,1260,2488
364547,30064,Muzzana del Turgnano,1227,1256,2483
364649,30065,Nimis,1350,1356,2706
364751,30066,Osoppo,1404,1454,2858
364853,30067,Ovaro,913,954,1867
364955,30068,Pagnacco,2476,2612,5088
365057,30069,Palazzolo dello Stella,1422,1495,2917
365159,30070,Palmanova,2599,2789,5388
365261,30071,Paluzza,1042,1077,2119
365363,30072,Pasian di Prato,4521,4874,9395
365465,30073,Paularo,1260,1281,2541
365567,30074,Pavia di Udine,2723,2808,5531
365669,30075,Pocenia,1237,1239,2476
365771,30076,Pontebba,683,696,1379
365873,30077,Porpetto,1264,1283,2547
365975,30078,Povoletto,2673,2782,5455
366077,30079,Pozzuolo del Friuli,3372,3544,6916
366179,30080,Pradamano,1743,1857,3600
366281,30081,Prato Carnico,452,451,903
366383,30082,Precenicco,733,730,1463
366485,30083,Premariacco,1989,2071,4060
366587,30084,Preone,118,116,234
366689,30085,Prepotto,375,372,747
366791,30086,Pulfero,468,448,916
366893,30087,Ragogna,1395,1442,2837
366995,30088,Ravascletto,253,248,501
367097,30089,Raveo,216,227,443
367199,30090,Reana del Rojale,2397,2493,4890
367301,30091,Remanzacco,2966,3134,6100
367403,30092,Resia,500,470,970
367505,30093,Resiutta,142,143,285
367607,30094,Rigolato,216,198,414
367709,30095,Rive d'Arcano,1180,1235,2415
367811,30097,Ronchis,987,1025,2012
367913,30098,Ruda,1379,1496,2875
368015,30099,San Daniele del Friuli,3823,4184,8007
368117,30100,San Giorgio di Nogaro,3642,3766,7408
368219,30101,San Giovanni al Natisone,3094,3028,6122
368321,30102,San Leonardo,561,521,1082
368423,30103,San Pietro al Natisone,1045,1089,2134
368525,30104,Santa Maria la Longa,1129,1188,2317
368627,30105,San Vito al Torre,599,658,1257
368729,30106,San Vito di Fagagna,831,845,1676
368831,30107,Sauris,188,208,396
368933,30108,Savogna,192,179,371
369035,30109,Sedegliano,1880,1879,3759
369137,30110,Socchieve,442,456,898
369239,30111,Stregna,177,153,330
369341,30112,Sutrio,626,652,1278
369443,30113,Taipana,319,269,588
369545,30114,Talmassons,1973,2023,3996
369647,30116,Tarcento,4274,4647,8921
369749,30117,Tarvisio,2178,2033,4211
369851,30118,Tavagnacco,7076,7848,14924
369953,30120,Terzo d'Aquileia,1377,1441,2818
370055,30121,Tolmezzo,4889,5280,10169
370157,30122,Torreano,1013,1081,2094
370259,30123,Torviscosa,1383,1421,2804
370361,30124,Trasaghis,1096,1113,2209
370463,30126,Treppo Grande,821,884,1705
370565,30127,Tricesimo,3692,4011,7703
370667,30128,Trivignano Udinese,802,831,1633
370769,30129,Udine,46292,53085,99377
370871,30130,Varmo,1352,1350,2702
370973,30131,Venzone,1014,989,2003
371075,30132,Verzegnis,442,430,872
371177,30133,Villa Santina,1040,1159,2199
371279,30135,Visco,386,413,799
371381,30136,Zuglio,281,287,568
371483,30137,Forgaria nel Friuli,876,869,1745
371585,30138,Campolongo Tapogliano,571,578,1149
371687,30188,Rivignano Teor,3130,3135,6265
371789,30189,Sappada,642,664,1306
371891,30190,Fiumicello Villa Vicentina,3119,3196,6315
371993,30191,Treppo Ligosullo,359,352,711
372095,31001,Capriva del Friuli,824,894,1718
372197,31002,Cormons,3434,3868,7302
372299,31003,Doberdò del Lago,657,707,1364
372401,31004,Dolegna del Collio,180,156,336
372503,31005,Farra d'Isonzo,840,849,1689
372605,31006,Fogliano Redipuglia,1503,1561,3064
372707,31007,Gorizia,16639,17697,34336
372809,31008,Gradisca d'Isonzo,3086,3382,6468
372911,31009,Grado,3884,4196,8080
373013,31010,Mariano del Friuli,735,755,1490
373115,31011,Medea,483,485,968
373217,31012,Monfalcone,14455,13998,28453
373319,31013,Moraro,366,372,738
373421,31014,Mossa,741,806,1547
373523,31015,Romans d'Isonzo,1815,1894,3709
373625,31016,Ronchi dei Legionari,5837,6091,11928
373727,31017,Sagrado,1081,1116,2197
373829,31018,San Canzian d'Isonzo,3053,3150,6203
373931,31019,San Floriano del Collio,390,378,768
374033,31020,San Lorenzo Isontino,786,762,1548
374135,31021,San Pier d'Isonzo,1012,993,2005
374237,31022,Savogna d'Isonzo,872,818,1690
374339,31023,Staranzano,3606,3650,7256
374441,31024,Turriaco,1401,1453,2854
374543,31025,Villesse,842,850,1692
374645,32001,Duino Aurisina,4066,4405,8471
374747,32002,Monrupino,417,448,865
374849,32003,Muggia,6292,6770,13062
374951,32004,San Dorligo della Valle,2826,2934,5760
375053,32005,Sgonico,1021,1047,2068
375155,32006,Trieste,97916,106351,204267
375257,33001,Agazzano,986,1053,2039
375359,33002,Alseno,2299,2397,4696
375461,33003,Besenzone,501,486,987
375563,33004,Bettola,1379,1344,2723
375665,33005,Bobbio,1712,1860,3572
375767,33006,Borgonovo Val Tidone,3963,4036,7999
375869,33007,Cadeo,2978,3088,6066
375971,33008,Calendasco,1248,1169,2417
376073,33010,Caorso,2382,2426,4808
376175,33011,Carpaneto Piacentino,3857,3883,7740
376277,33012,Castell'Arquato,2247,2344,4591
376379,33013,Castel San Giovanni,6768,6957,13725
376481,33014,Castelvetro Piacentino,2597,2704,5301
376583,33015,Cerignale,72,50,122
376685,33016,Coli,438,407,845
376787,33017,Corte Brugnatella,281,305,586
376889,33018,Cortemaggiore,2365,2318,4683
376991,33019,Farini,566,602,1168
377093,33020,Ferriere,642,555,1197
377195,33021,Fiorenzuola d'Arda,7456,7844,15300
377297,33022,Gazzola,1062,1013,2075
377399,33023,Gossolengo,2821,2869,5690
377501,33024,Gragnano Trebbiense,2256,2283,4539
377603,33025,Gropparello,1132,1111,2243
377705,33026,Lugagnano Val d'Arda,1926,2001,3927
377807,33027,Monticelli d'Ongina,2590,2651,5241
377909,33028,Morfasso,501,456,957
378011,33030,Ottone,260,225,485
378113,33032,Piacenza,49784,54158,103942
378215,33033,Pianello Val Tidone,1100,1119,2219
378317,33034,Piozzano,330,279,609
378419,33035,Podenzano,4517,4597,9114
378521,33036,Ponte dell'Olio,2316,2391,4707
378623,33037,Pontenure,3184,3342,6526
378725,33038,Rivergaro,3463,3578,7041
378827,33039,Rottofreno,6044,6257,12301
378929,33040,San Giorgio Piacentino,2750,2859,5609
379031,33041,San Pietro in Cerro,418,414,832
379133,33042,Sarmato,1433,1414,2847
379235,33043,Travo,1052,1052,2104
379337,33044,Vernasca,1038,1035,2073
379439,33045,Vigolzone,2103,2104,4207
379541,33046,Villanova sull'Arda,859,845,1704
379643,33047,Zerba,41,32,73
379745,33048,Ziano Piacentino,1295,1211,2506
379847,33049,Alta Val Tidone,1518,1498,3016
379949,34001,Albareto,1073,1072,2145
380051,34002,Bardi,1076,1074,2150
380153,34003,Bedonia,1634,1686,3320
380255,34004,Berceto,1023,967,1990
380357,34005,Bore,340,343,683
380459,34006,Borgo Val di Taro,3334,3515,6849
380561,34007,Busseto,3423,3488,6911
380663,34008,Calestano,1106,1012,2118
380765,34009,Collecchio,7260,7456,14716
380867,34010,Colorno,4529,4575,9104
380969,34011,Compiano,562,542,1104
381071,34012,Corniglio,941,901,1842
381173,34013,Felino,4424,4559,8983
381275,34014,Fidenza,13089,13952,27041
381377,34015,Fontanellato,3507,3554,7061
381479,34016,Fontevivo,2828,2813,5641
381581,34017,Fornovo di Taro,2919,3088,6007
381683,34018,Langhirano,5211,5273,10484
381785,34019,Lesignano de' Bagni,2530,2524,5054
381887,34020,Medesano,5369,5515,10884
381989,34022,Monchio delle Corti,474,406,880
382091,34023,Montechiarugolo,5545,5559,11104
382193,34024,Neviano degli Arduini,1787,1813,3600
382295,34025,Noceto,6377,6656,13033
382397,34026,Palanzano,584,515,1099
382499,34027,Parma,94338,102180,196518
382601,34028,Pellegrino Parmense,498,514,1012
382703,34030,Roccabianca,1458,1476,2934
382805,34031,Sala Baganza,2868,2811,5679
382907,34032,Salsomaggiore Terme,9668,10078,19746
383009,34033,San Secondo Parmense,2847,2892,5739
383111,34035,Solignano,905,838,1743
383213,34036,Soragna,2408,2433,4841
383315,34038,Terenzo,601,598,1199
383417,34039,Tizzano Val Parma,1060,1044,2104
383519,34040,Tornolo,497,442,939
383621,34041,Torrile,3862,3827,7689
383723,34042,Traversetolo,4715,4823,9538
383825,34044,Valmozzola,260,255,515
383927,34045,Varano de' Melegari,1284,1341,2625
384029,34046,Varsi,583,602,1185
384131,34049,Sissa Trecasali,3849,3997,7846
384233,34050,Polesine Zibello,1553,1635,3188
384335,34051,Sorbolo Mezzani,6325,6463,12788
384437,35001,Albinea,4290,4515,8805
384539,35002,Bagnolo in Piano,4799,4990,9789
384641,35003,Baiso,1649,1593,3242
384743,35004,Bibbiano,5071,5151,10222
384845,35005,Boretto,2627,2738,5365
384947,35006,Brescello,2821,2776,5597
385049,35008,Cadelbosco di Sopra,5249,5446,10695
385151,35009,Campagnola Emilia,2805,2866,5671
385253,35010,Campegine,2539,2617,5156
385355,35011,Carpineti,1981,2026,4007
385457,35012,Casalgrande,9502,9480,18982
385559,35013,Casina,2191,2250,4441
385661,35014,Castellarano,7630,7716,15346
385763,35015,Castelnovo di Sotto,4193,4289,8482
385865,35016,Castelnovo ne' Monti,5118,5388,10506
385967,35017,Cavriago,4784,5114,9898
386069,35018,Canossa,1911,1829,3740
386171,35020,Correggio,12459,13026,25485
386273,35021,Fabbrico,3319,3308,6627
386375,35022,Gattatico,2901,2862,5763
386477,35023,Gualtieri,3235,3272,6507
386579,35024,Guastalla,7356,7662,15018
386681,35026,Luzzara,4459,4381,8840
386783,35027,Montecchio Emilia,5098,5401,10499
386885,35028,Novellara,6678,6929,13607
386987,35029,Poviglio,3647,3648,7295
387089,35030,Quattro Castella,6403,6766,13169
387191,35032,Reggiolo,4591,4562,9153
387293,35033,Reggio nell'Emilia,83905,88094,171999
387395,35034,Rio Saliceto,3052,3036,6088
387497,35035,Rolo,2058,2017,4075
387599,35036,Rubiera,7300,7561,14861
387701,35037,San Martino in Rio,4051,4075,8126
387803,35038,San Polo d'Enza,3048,3169,6217
387905,35039,Sant'Ilario d'Enza,5564,5769,11333
388007,35040,Scandiano,12527,13243,25770
388109,35041,Toano,2223,2144,4367
388211,35042,Vetto,929,893,1822
388313,35043,Vezzano sul Crostolo,2073,2164,4237
388415,35044,Viano,1662,1663,3325
388517,35045,Villa Minozzo,1811,1823,3634
388619,35046,Ventasso,2054,2076,4130
388721,36001,Bastiglia,2128,2135,4263
388823,36002,Bomporto,5095,5094,10189
388925,36003,Campogalliano,4335,4467,8802
389027,36004,Camposanto,1590,1582,3172
389129,36005,Carpi,34792,37044,71836
389231,36006,Castelfranco Emilia,16534,16525,33059
389333,36007,Castelnuovo Rangone,7603,7480,15083
389435,36008,Castelvetro di Modena,5729,5594,11323
389537,36009,Cavezzo,3389,3571,6960
389639,36010,Concordia sulla Secchia,4107,4266,8373
389741,36011,Fanano,1437,1513,2950
389843,36012,Finale Emilia,7506,7909,15415
389945,36013,Fiorano Modenese,8440,8624,17064
390047,36014,Fiumalbo,601,621,1222
390149,36015,Formigine,17095,17464,34559
390251,36016,Frassinoro,938,945,1883
390353,36017,Guiglia,1977,1930,3907
390455,36018,Lama Mocogno,1321,1354,2675
390557,36019,Maranello,8783,8897,17680
390659,36020,Marano sul Panaro,2634,2630,5264
390761,36021,Medolla,3030,3226,6256
390863,36022,Mirandola,11536,12359,23895
390965,36023,Modena,89487,96820,186307
391067,36024,Montecreto,491,446,937
391169,36025,Montefiorino,1072,1050,2122
391271,36026,Montese,1651,1664,3315
391373,36027,Nonantola,7962,8160,16122
391475,36028,Novi di Modena,5003,5063,10066
391577,36029,Palagano,1052,1068,2120
391679,36030,Pavullo nel Frignano,8738,8942,17680
391781,36031,Pievepelago,1191,1136,2327
391883,36032,Polinago,804,814,1618
391985,36033,Prignano sulla Secchia,1894,1840,3734
392087,36034,Ravarino,3046,3127,6173
392189,36035,Riolunato,363,329,692
392291,36036,San Cesario sul Panaro,3226,3287,6513
392393,36037,San Felice sul Panaro,5336,5526,10862
392495,36038,San Possidonio,1727,1825,3552
392597,36039,San Prospero,3032,2945,5977
392699,36040,Sassuolo,19949,20969,40918
392801,36041,Savignano sul Panaro,4558,4693,9251
392903,36042,Serramazzoni,4289,4141,8430
393005,36043,Sestola,1230,1255,2485
393107,36044,Soliera,7579,7848,15427
393209,36045,Spilamberto,6410,6449,12859
393311,36046,Vignola,12378,13115,25493
393413,36047,Zocca,2326,2257,4583
393515,37001,Anzola dell'Emilia,6041,6282,12323
393617,37002,Argelato,4832,5002,9834
393719,37003,Baricella,3518,3597,7115
393821,37005,Bentivoglio,2763,2866,5629
393923,37006,Bologna,184631,206005,390636
394025,37007,Borgo Tossignano,1626,1647,3273
394127,37008,Budrio,8987,9473,18460
394229,37009,Calderara di Reno,6478,6778,13256
394331,37010,Camugnano,896,929,1825
394433,37011,Casalecchio di Reno,17244,19268,36512
394535,37012,Casalfiumanese,1721,1737,3458
394637,37013,Castel d'Aiano,955,917,1872
394739,37014,Castel del Rio,581,643,1224
394841,37015,Castel di Casio,1693,1717,3410
394943,37016,Castel Guelfo di Bologna,2273,2264,4537
395045,37017,Castello d'Argile,3300,3246,6546
395147,37019,Castel Maggiore,8904,9520,18424
395249,37020,Castel San Pietro Terme,10291,10693,20984
395351,37021,Castenaso,7459,8086,15545
395453,37022,Castiglione dei Pepoli,2721,2777,5498
395555,37024,Crevalcore,6709,6983,13692
395657,37025,Dozza,3235,3352,6587
395759,37026,Fontanelice,979,969,1948
395861,37027,Gaggio Montano,2377,2463,4840
395963,37028,Galliera,2736,2771,5507
396065,37030,Granarolo dell'Emilia,5952,6178,12130
396167,37031,Grizzana Morandi,2007,1887,3894
396269,37032,Imola,33625,36173,69798
396371,37033,Lizzano in Belvedere,1072,1110,2182
396473,37034,Loiano,2169,2129,4298
396575,37035,Malalbergo,4429,4688,9117
396677,37036,Marzabotto,3421,3413,6834
396779,37037,Medicina,8195,8587,16782
396881,37038,Minerbio,4344,4527,8871
396983,37039,Molinella,7576,8032,15608
397085,37040,Monghidoro,1874,1824,3698
397187,37041,Monterenzio,3100,3061,6161
397289,37042,Monte San Pietro,5356,5519,10875
397391,37044,Monzuno,3193,3168,6361
397493,37045,Mordano,2366,2317,4683
397595,37046,Ozzano dell'Emilia,6750,7067,13817
397697,37047,Pianoro,8556,9052,17608
397799,37048,Pieve di Cento,3474,3654,7128
397901,37050,Sala Bolognese,4211,4254,8465
398003,37051,San Benedetto Val di Sambro,2118,2041,4159
398105,37052,San Giorgio di Piano,4243,4577,8820
398207,37053,San Giovanni in Persiceto,13731,14561,28292
398309,37054,San Lazzaro di Savena,15495,17023,32518
398411,37055,San Pietro in Casale,6171,6264,12435
398513,37056,Sant'Agata Bolognese,3714,3690,7404
398615,37057,Sasso Marconi,7242,7667,14909
398717,37059,Vergato,3807,3902,7709
398819,37060,Zola Predosa,9256,9759,19015
398921,37061,Valsamoggia,15506,15703,31209
399023,37062,Alto Reno Terme,3324,3580,6904
399125,38001,Argenta,10400,11029,21429
399227,38003,Bondeno,6805,7328,14133
399329,38004,Cento,17413,18061,35474
399431,38005,Codigoro,5507,6096,11603
399533,38006,Comacchio,10850,11264,22114
399635,38007,Copparo,7724,8510,16234
399737,38008,Ferrara,62272,69780,132052
399839,38010,Jolanda di Savoia,1382,1432,2814
399941,38011,Lagosanto,2357,2485,4842
400043,38012,Masi Torello,1074,1227,2301
400145,38014,Mesola,3283,3443,6726
400247,38017,Ostellato,2914,3021,5935
400349,38018,Poggio Renatico,4809,4977,9786
400451,38019,Portomaggiore,5636,5968,11604
400553,38022,Vigarano Mainarda,3700,3883,7583
400655,38023,Voghiera,1785,1889,3674
400757,38025,Goro,1783,1916,3699
400859,38027,Fiscaglia,4296,4492,8788
400961,38028,Terre del Reno,4858,5138,9996
401063,38029,Riva del Po,3872,3967,7839
401165,38030,Tresignana,3379,3686,7065
401267,39001,Alfonsine,5769,6169,11938
401369,39002,Bagnacavallo,8157,8557,16714
401471,39003,Bagnara di Romagna,1207,1223,2430
401573,39004,Brisighella,3750,3748,7498
401675,39005,Casola Valsenio,1294,1226,2520
401777,39006,Castel Bolognese,4722,4877,9599
401879,39007,Cervia,13798,15021,28819
401981,39008,Conselice,4783,4969,9752
402083,39009,Cotignola,3559,3816,7375
402185,39010,Faenza,28696,30059,58755
402287,39011,Fusignano,4005,4152,8157
402389,39012,Lugo,15469,16814,32283
402491,39013,Massa Lombarda,5242,5315,10557
402593,39014,Ravenna,76416,81247,157663
402695,39015,Riolo Terme,2851,2830,5681
402797,39016,Russi,6047,6259,12306
402899,39017,Sant'Agata sul Santerno,1460,1469,2929
403001,39018,Solarolo,2165,2315,4480
403103,40001,Bagno di Romagna,2824,2991,5815
403205,40003,Bertinoro,5331,5596,10927
403307,40004,Borghi,1451,1433,2884
403409,40005,Castrocaro Terme e Terra del Sole,3103,3274,6377
403511,40007,Cesena,46962,50248,97210
403613,40008,Cesenatico,12578,13355,25933
403715,40009,Civitella di Romagna,1824,1900,3724
403817,40011,Dovadola,761,812,1573
403919,40012,Forlì,56855,60943,117798
404021,40013,Forlimpopoli,6499,6775,13274
404123,40014,Galeata,1246,1254,2500
404225,40015,Gambettola,5193,5540,10733
404327,40016,Gatteo,4534,4598,9132
404429,40018,Longiano,3502,3698,7200
404531,40019,Meldola,4902,5059,9961
404633,40020,Mercato Saraceno,3439,3421,6860
404735,40022,Modigliana,2217,2257,4474
404837,40028,Montiano,840,882,1722
404939,40031,Portico e San Benedetto,379,374,753
405041,40032,Predappio,3139,3146,6285
405143,40033,Premilcuore,379,374,753
405245,40036,Rocca San Casciano,885,943,1828
405347,40037,Roncofreddo,1715,1691,3406
405449,40041,San Mauro Pascoli,5892,6125,12017
405551,40043,Santa Sofia,1986,2128,4114
405653,40044,Sarsina,1665,1715,3380
405755,40045,Savignano sul Rubicone,8818,9024,17842
405857,40046,Sogliano al Rubicone,1587,1606,3193
405959,40049,Tredozio,560,581,1141
406061,40050,Verghereto,929,889,1818
406163,41001,Acqualagna,2166,2205,4371
406265,41002,Apecchio,884,919,1803
406367,41005,Belforte all'Isauro,361,380,741
406469,41006,Borgo Pace,285,287,572
406571,41007,Cagli,4074,4334,8408
406673,41008,Cantiano,1064,1107,2171
406775,41009,Carpegna,822,846,1668
406877,41010,Cartoceto,3916,4010,7926
406979,41013,Fano,29332,31540,60872
407081,41014,Fermignano,4127,4329,8456
407183,41015,Fossombrone,4641,4754,9395
407285,41016,Fratte Rosa,468,468,936
407387,41017,Frontino,142,143,285
407489,41018,Frontone,607,658,1265
407591,41019,Gabicce Mare,2776,2904,5680
407693,41020,Gradara,2456,2418,4874
407795,41021,Isola del Piano,287,275,562
407897,41022,Lunano,772,721,1493
407999,41023,Macerata Feltria,960,1034,1994
408101,41025,Mercatello sul Metauro,666,668,1334
408203,41026,Mercatino Conca,515,516,1031
408305,41027,Mombaroccio,1044,1033,2077
408407,41028,Mondavio,1877,1940,3817
408509,41029,Mondolfo,7141,7219,14360
408611,41030,Montecalvo in Foglia,1341,1421,2762
408713,41031,Monte Cerignone,318,335,653
408815,41032,Monteciccardo,819,821,1640
408917,41033,Montecopiolo,555,536,1091
409019,41034,Montefelcino,1318,1297,2615
409121,41035,Monte Grimano Terme,557,560,1117
409223,41036,Montelabbate,3553,3437,6990
409325,41038,Monte Porzio,1421,1414,2835
409427,41041,Peglio,338,348,686
409529,41043,Pergola,2961,3190,6151
409631,41044,Pesaro,45454,49515,94969
409733,41045,Petriano,1412,1390,2802
409835,41047,Piandimeleto,1057,1073,2130
409937,41048,Pietrarubbia,330,317,647
410039,41049,Piobbico,946,970,1916
410141,41051,San Costanzo,2357,2354,4711
410243,41054,San Lorenzo in Campo,1587,1738,3325
410345,41057,Sant'Angelo in Vado,2021,2033,4054
410447,41058,Sant'Ippolito,746,761,1507
410549,41060,Sassofeltrio,677,734,1411
410651,41061,Serra Sant'Abbondio,472,491,963
410753,41064,Tavoleto,424,446,870
410855,41065,Tavullia,3979,3968,7947
410957,41066,Urbania,3395,3595,6990
411059,41067,Urbino,7009,7352,14361
411161,41068,Vallefoglia,7594,7539,15133
411263,41069,Colli al Metauro,6128,6213,12341
411365,41070,Terre Roveresche,2623,2615,5238
411467,41071,Sassocorvaro Auditore,2449,2491,4940
411569,42001,Agugliano,2315,2418,4733
411671,42002,Ancona,48559,52484,101043
411773,42003,Arcevia,2147,2261,4408
411875,42004,Barbara,662,665,1327
411977,42005,Belvedere Ostrense,1075,1106,2181
412079,42006,Camerano,3479,3646,7125
412181,42007,Camerata Picena,1269,1289,2558
412283,42008,Castelbellino,2411,2633,5044
412385,42010,Castelfidardo,9157,9526,18683
412487,42011,Castelleone di Suasa,788,800,1588
412589,42012,Castelplanio,1678,1768,3446
412691,42013,Cerreto d'Esi,1812,1838,3650
412793,42014,Chiaravalle,6955,7778,14733
412895,42015,Corinaldo,2416,2511,4927
412997,42016,Cupramontana,2245,2333,4578
413099,42017,Fabriano,14610,15899,30509
413201,42018,Falconara Marittima,12460,13446,25906
413303,42019,Filottrano,4598,4700,9298
413405,42020,Genga,827,881,1708
413507,42021,Jesi,19115,20854,39969
413609,42022,Loreto,6131,6655,12786
413711,42023,Maiolati Spontini,2967,3234,6201
413813,42024,Mergo,487,526,1013
413915,42025,Monsano,1628,1722,3350
414017,42026,Montecarotto,923,990,1913
414119,42027,Montemarciano,4896,4977,9873
414221,42029,Monte Roberto,1501,1558,3059
414323,42030,Monte San Vito,3331,3484,6815
414425,42031,Morro d'Alba,902,952,1854
414527,42032,Numana,1909,1886,3795
414629,42033,Offagna,998,1027,2025
414731,42034,Osimo,17191,17816,35007
414833,42035,Ostra,3242,3424,6666
414935,42036,Ostra Vetere,1595,1639,3234
415037,42037,Poggio San Marcello,332,339,671
415139,42038,Polverigi,2274,2278,4552
415241,42040,Rosora,948,1002,1950
415343,42041,San Marcello,991,1017,2008
415445,42042,San Paolo di Jesi,436,480,916
415547,42043,Santa Maria Nuova,2002,2095,4097
415649,42044,Sassoferrato,3431,3639,7070
415751,42045,Senigallia,21341,23279,44620
415853,42046,Serra de' Conti,1853,1884,3737
415955,42047,Serra San Quirico,1294,1465,2759
416057,42048,Sirolo,1941,2122,4063
416159,42049,Staffolo,1077,1134,2211
416261,42050,Trecastelli,3771,3798,7569
416363,43002,Apiro,1048,1148,2196
416465,43003,Appignano,2010,2145,4155
416567,43004,Belforte del Chienti,943,961,1904
416669,43005,Bolognola,76,65,141
416771,43006,Caldarola,835,875,1710
416873,43007,Camerino,3360,3492,6852
416975,43008,Camporotondo di Fiastrone,246,279,525
417077,43009,Castelraimondo,2166,2283,4449
417179,43010,Castelsantangelo sul Nera,134,115,249
417281,43011,Cessapalombo,228,254,482
417383,43012,Cingoli,4886,5196,10082
417485,43013,Civitanova Marche,20274,22202,42476
417587,43014,Colmurano,610,614,1224
417689,43015,Corridonia,7454,7758,15212
417791,43016,Esanatoglia,903,1020,1923
417893,43017,Fiastra,340,323,663
417995,43019,Fiuminata,637,680,1317
418097,43020,Gagliole,305,294,599
418199,43021,Gualdo,381,393,774
418301,43022,Loro Piceno,1105,1198,2303
418403,43023,Macerata,19670,21844,41514
418505,43024,Matelica,4650,4962,9612
418607,43025,Mogliano,2251,2320,4571
418709,43026,Montecassiano,3465,3589,7054
418811,43027,Monte Cavallo,63,59,122
418913,43028,Montecosaro,3561,3666,7227
419015,43029,Montefano,1667,1733,3400
419117,43030,Montelupone,1746,1792,3538
419219,43031,Monte San Giusto,3871,3981,7852
419321,43032,Monte San Martino,371,363,734
419423,43033,Morrovalle,5014,5064,10078
419525,43034,Muccia,423,455,878
419627,43035,Penna San Giovanni,492,543,1035
419729,43036,Petriolo,956,973,1929
419831,43038,Pieve Torina,676,683,1359
419933,43039,Pioraco,505,557,1062
420035,43040,Poggio San Vicino,119,122,241
420137,43041,Pollenza,3176,3299,6475
420239,43042,Porto Recanati,6468,6073,12541
420341,43043,Potenza Picena,7718,8132,15850
420443,43044,Recanati,10205,10892,21097
420545,43045,Ripe San Ginesio,405,432,837
420647,43046,San Ginesio,1601,1677,3278
420749,43047,San Severino Marche,5949,6395,12344
420851,43048,Sant'Angelo in Pontano,648,713,1361
420953,43049,Sarnano,1522,1657,3179
421055,43050,Sefro,223,215,438
421157,43051,Serrapetrona,450,472,922
421259,43052,Serravalle di Chienti,522,487,1009
421361,43053,Tolentino,9267,9846,19113
421463,43054,Treia,4548,4707,9255
421565,43055,Urbisaglia,1280,1271,2551
421667,43056,Ussita,197,212,409
421769,43057,Visso,504,558,1062
421871,43058,Valfornace,508,507,1015
421973,44001,Acquasanta Terme,1344,1352,2696
422075,44002,Acquaviva Picena,1841,1906,3747
422177,44005,Appignano del Tronto,843,885,1728
422279,44006,Arquata del Tronto,549,538,1087
422381,44007,Ascoli Piceno,23189,24980,48169
422483,44010,Carassai,497,521,1018
422585,44011,Castel di Lama,4244,4345,8589
422687,44012,Castignano,1332,1377,2709
422789,44013,Castorano,1140,1175,2315
422891,44014,Colli del Tronto,1821,1896,3717
422993,44015,Comunanza,1526,1530,3056
423095,44016,Cossignano,442,480,922
423197,44017,Cupra Marittima,2571,2790,5361
423299,44020,Folignano,4563,4575,9138
423401,44021,Force,622,627,1249
423503,44023,Grottammare,7664,8409,16073
423605,44027,Maltignano,1153,1184,2337
423707,44029,Massignano,818,833,1651
423809,44031,Monsampolo del Tronto,2298,2293,4591
423911,44032,Montalto delle Marche,933,1104,2037
424013,44034,Montedinove,284,226,510
424115,44036,Montefiore dell'Aso,993,1040,2033
424217,44038,Montegallo,252,224,476
424319,44044,Montemonaco,272,279,551
424421,44045,Monteprandone,6286,6422,12708
424523,44054,Offida,2414,2513,4927
424625,44056,Palmiano,85,100,185
424727,44063,Ripatransone,2061,2141,4202
424829,44064,Roccafluvione,997,970,1967
424931,44065,Rotella,420,429,849
425033,44066,San Benedetto del Tronto,22346,24984,47330
425135,44071,Spinetoli,3530,3724,7254
425237,44073,Venarotta,982,1015,1997
425339,45001,Aulla,5359,5708,11067
425441,45002,Bagnone,898,916,1814
425543,45003,Carrara,29889,32396,62285
425645,45004,Casola in Lunigiana,476,530,1006
425747,45005,Comano,344,355,699
425849,45006,Filattiera,1084,1160,2244
425951,45007,Fivizzano,3701,3878,7579
426053,45008,Fosdinovo,2303,2399,4702
426155,45009,Licciana Nardi,2412,2460,4872
426257,45010,Massa,33205,35684,68889
426359,45011,Montignoso,4993,5305,10298
426461,45012,Mulazzo,1188,1210,2398
426563,45013,Podenzana,1068,1072,2140
426665,45014,Pontremoli,3377,3805,7182
426767,45015,Tresana,969,993,1962
426869,45016,Villafranca in Lunigiana,2349,2378,4727
426971,45017,Zeri,493,521,1014
427073,46001,Altopascio,7624,7908,15532
427175,46002,Bagni di Lucca,2905,3027,5932
427277,46003,Barga,4831,4987,9818
427379,46004,Borgo a Mozzano,3423,3535,6958
427481,46005,Camaiore,15557,16726,32283
427583,46006,Camporgiano,1073,1060,2133
427685,46007,Capannori,22772,23444,46216
427787,46008,Careggine,269,267,536
427889,46009,Castelnuovo di Garfagnana,2822,3029,5851
427991,46010,Castiglione di Garfagnana,880,878,1758
428093,46011,Coreglia Antelminelli,2523,2640,5163
428195,46013,Forte dei Marmi,3313,3936,7249
428297,46014,Fosciandora,283,306,589
428399,46015,Gallicano,1845,1852,3697
428501,46017,Lucca,42531,46293,88824
428603,46018,Massarosa,10907,11415,22322
428705,46019,Minucciano,970,1011,1981
428807,46020,Molazzana,509,525,1034
428909,46021,Montecarlo,2116,2254,4370
429011,46022,Pescaglia,1727,1712,3439
429113,46023,Piazza al Serchio,1081,1169,2250
429215,46024,Pietrasanta,11073,12527,23600
429317,46025,Pieve Fosciana,1229,1244,2473
429419,46026,Porcari,4443,4518,8961
429521,46027,San Romano in Garfagnana,693,710,1403
429623,46028,Seravezza,6100,6730,12830
429725,46030,Stazzema,1496,1520,3016
429827,46031,Vagli Sotto,468,439,907
429929,46033,Viareggio,29477,32579,62056
430031,46034,Villa Basilica,780,770,1550
430133,46035,Villa Collemandina,644,654,1298
430235,46036,Fabbriche di Vergemoli,434,387,821
430337,46037,Sillano Giuncugnano,501,525,1026
430439,47002,Agliana,8808,9112,17920
430541,47003,Buggiano,4279,4603,8882
430643,47005,Lamporecchio,3606,3834,7440
430745,47006,Larciano,3073,3248,6321
430847,47007,Marliana,1583,1589,3172
430949,47008,Massa e Cozzile,3755,4139,7894
431051,47009,Monsummano Terme,10274,10877,21151
431153,47010,Montale,5252,5502,10754
431255,47011,Montecatini-Terme,9592,11081,20673
431357,47012,Pescia,9499,10175,19674
431459,47013,Pieve a Nievole,4475,4761,9236
431561,47014,Pistoia,43234,47124,90358
431663,47016,Ponte Buggianese,4307,4549,8856
431765,47017,Quarrata,13000,13693,26693
431867,47018,Sambuca Pistoiese,801,767,1568
431969,47020,Serravalle Pistoiese,5668,6011,11679
432071,47021,Uzzano,2740,2929,5669
432173,47022,Chiesina Uzzanese,2236,2311,4547
432275,47023,Abetone Cutigliano,1016,1032,2048
432377,47024,San Marcello Piteglio,3750,4188,7938
432479,48001,Bagno a Ripoli,12127,13439,25566
432581,48002,Barberino di Mugello,5408,5529,10937
432683,48004,Borgo San Lorenzo,8966,9353,18319
432785,48005,Calenzano,8740,9200,17940
432887,48006,Campi Bisenzio,23150,23991,47141
432989,48008,Capraia e Limite,3882,3947,7829
433091,48010,Castelfiorentino,8404,8932,17336
433193,48011,Cerreto Guidi,5277,5654,10931
433295,48012,Certaldo,7855,8143,15998
433397,48013,Dicomano,2797,2717,5514
433499,48014,Empoli,23421,25374,48795
433601,48015,Fiesole,6737,7351,14088
433703,48017,Firenze,177916,200923,378839
433805,48018,Firenzuola,2253,2302,4555
433907,48019,Fucecchio,11290,11792,23082
434009,48020,Gambassi Terme,2352,2455,4807
434111,48021,Greve in Chianti,6733,7070,13803
434213,48022,Impruneta,7049,7594,14643
434315,48024,Lastra a Signa,9992,10302,20294
434417,48025,Londa,996,915,1911
434519,48026,Marradi,1512,1531,3043
434621,48027,Montaione,1768,1833,3601
434723,48028,Montelupo Fiorentino,6931,7370,14301
434825,48030,Montespertoli,6655,6819,13474
434927,48031,Palazzuolo sul Senio,569,551,1120
435029,48032,Pelago,3764,3947,7711
435131,48033,Pontassieve,10011,10678,20689
435233,48035,Reggello,8193,8370,16563
435335,48036,Rignano sull'Arno,4290,4349,8639
435437,48037,Rufina,3545,3637,7182
435539,48038,San Casciano in Val di Pesa,8283,8876,17159
435641,48039,San Godenzo,549,560,1109
435743,48041,Scandicci,24147,26404,50551
435845,48043,Sesto Fiorentino,23422,25909,49331
435947,48044,Signa,9121,9753,18874
436049,48046,Vaglia,2524,2647,5171
436151,48049,Vicchio,4078,4061,8139
436253,48050,Vinci,7104,7504,14608
436355,48052,Figline e Incisa Valdarno,11339,12072,23411
436457,48053,Scarperia e San Piero,6012,6208,12220
436559,48054,Barberino Tavarnelle,6005,6120,12125
436661,49001,Bibbona,1650,1599,3249
436763,49002,Campiglia Marittima,6203,6683,12886
436865,49003,Campo nell'Elba,2387,2453,4840
436967,49004,Capoliveri,2001,2045,4046
437069,49005,Capraia Isola,225,182,407
437171,49006,Castagneto Carducci,4454,4601,9055
437273,49007,Cecina,13319,14782,28101
437375,49008,Collesalvetti,8203,8559,16762
437477,49009,Livorno,75732,82051,157783
437579,49010,Marciana,1023,1099,2122
437681,49011,Marciana Marina,976,982,1958
437783,49012,Piombino,16152,17407,33559
437885,49013,Porto Azzurro,1890,1796,3686
437987,49014,Portoferraio,5783,6228,12011
438089,49017,Rosignano Marittimo,14781,16026,30807
438191,49018,San Vincenzo,3153,3585,6738
438293,49019,Sassetta,226,245,471
438395,49020,Suvereto,1522,1540,3062
438497,49021,Rio,1629,1660,3289
438599,50001,Bientina,4070,4361,8431
438701,50002,Buti,2752,2842,5594
438803,50003,Calci,3097,3308,6405
438905,50004,Calcinaia,6232,6494,12726
439007,50005,Capannoli,3131,3264,6395
439109,50006,Casale Marittimo,554,549,1103
439211,50008,Cascina,21794,23265,45059
439313,50009,Castelfranco di Sotto,6677,6743,13420
439415,50010,Castellina Marittima,966,974,1940
439517,50011,Castelnuovo di Val di Cecina,1051,1111,2162
439619,50012,Chianni,661,678,1339
439721,50014,Fauglia,1826,1858,3684
439823,50015,Guardistallo,583,637,1220
439925,50016,Lajatico,632,679,1311
440027,50019,Montecatini Val di Cecina,837,832,1669
440129,50020,Montescudaio,1045,1121,2166
440231,50021,Monteverdi Marittimo,384,372,756
440333,50022,Montopoli in Val d'Arno,5491,5658,11149
440435,50023,Orciano Pisano,299,316,615
440537,50024,Palaia,2180,2362,4542
440639,50025,Peccioli,2287,2455,4742
440741,50026,Pisa,42514,46366,88880
440843,50027,Pomarance,2790,2871,5661
440945,50028,Ponsacco,7654,7944,15598
441047,50029,Pontedera,14259,14964,29223
441149,50030,Riparbella,805,807,1612
441251,50031,San Giuliano Terme,15152,16043,31195
441353,50032,San Miniato,13655,14304,27959
441455,50033,Santa Croce sull'Arno,7334,7260,14594
441557,50034,Santa Luce,827,811,1638
441659,50035,Santa Maria a Monte,6503,6654,13157
441761,50036,Terricciola,2213,2296,4509
441863,50037,Vecchiano,5831,6237,12068
441965,50038,Vicopisano,4162,4431,8593
442067,50039,Volterra,4816,5343,10159
442169,50040,Casciana Terme Lari,6061,6266,12327
442271,50041,Crespina Lorenzana,2700,2736,5436
442373,51001,Anghiari,2718,2783,5501
442475,51002,Arezzo,47733,51446,99179
442577,51003,Badia Tedalda,569,482,1051
442679,51004,Bibbiena,6039,6037,12076
442781,51005,Bucine,4920,5171,10091
442883,51006,Capolona,2569,2811,5380
442985,51007,Caprese Michelangelo,678,732,1410
443087,51008,Castel Focognano,1546,1546,3092
443189,51010,Castel San Niccolò,1289,1342,2631
443291,51011,Castiglion Fibocchi,1073,1051,2124
443393,51012,Castiglion Fiorentino,6499,6630,13129
443495,51013,Cavriglia,4766,4788,9554
443597,51014,Chitignano,445,448,893
443699,51015,Chiusi della Verna,987,971,1958
443801,51016,Civitella in Val di Chiana,4456,4547,9003
443903,51017,Cortona,10598,11386,21984
444005,51018,Foiano della Chiana,4648,4880,9528
444107,51020,Loro Ciuffenna,2912,2966,5878
444209,51021,Lucignano,1723,1821,3544
444311,51022,Marciano della Chiana,1652,1775,3427
444413,51023,Montemignaio,280,256,536
444515,51024,Monterchi,841,874,1715
444617,51025,Monte San Savino,4188,4514,8702
444719,51026,Montevarchi,11981,12509,24490
444821,51027,Ortignano Raggiolo,436,425,861
444923,51030,Pieve Santo Stefano,1522,1565,3087
445025,51031,Poppi,3066,3048,6114
445127,51033,San Giovanni Valdarno,7916,8907,16823
445229,51034,Sansepolcro,7641,8160,15801
445331,51035,Sestino,631,651,1282
445433,51037,Subbiano,3183,3229,6412
445535,51038,Talla,534,480,1014
445637,51039,Terranuova Bracciolini,6044,6224,12268
445739,51040,Castelfranco Piandiscò,4827,5001,9828
445841,51041,Pratovecchio Stia,2777,2875,5652
445943,51042,Laterina Pergine Valdarno,3266,3370,6636
446045,52001,Abbadia San Salvatore,2975,3300,6275
446147,52002,Asciano,3450,3588,7038
446249,52003,Buonconvento,1491,1611,3102
446351,52004,Casole d'Elsa,1878,1951,3829
446453,52005,Castellina in Chianti,1460,1354,2814
446555,52006,Castelnuovo Berardenga,4428,4684,9112
446657,52007,Castiglione d'Orcia,1088,1177,2265
446759,52008,Cetona,1246,1356,2602
446861,52009,Chianciano Terme,3335,3744,7079
446963,52010,Chiusdino,908,941,1849
447065,52011,Chiusi,4078,4351,8429
447167,52012,Colle di Val d'Elsa,10551,11186,21737
447269,52013,Gaiole in Chianti,1355,1350,2705
447371,52015,Montepulciano,6590,7234,13824
447473,52016,Monteriggioni,4909,5124,10033
447575,52017,Monteroni d'Arbia,4463,4607,9070
447677,52018,Monticiano,761,765,1526
447779,52019,Murlo,1226,1187,2413
447881,52020,Piancastagnaio,1999,2130,4129
447983,52021,Pienza,978,1096,2074
448085,52022,Poggibonsi,14067,14881,28948
448187,52023,Radda in Chianti,740,808,1548
448289,52024,Radicofani,528,534,1062
448391,52025,Radicondoli,472,450,922
448493,52026,Rapolano Terme,2636,2743,5379
448595,52027,San Casciano dei Bagni,766,812,1578
448697,52028,San Gimignano,3908,3852,7760
448799,52030,San Quirico d'Orcia,1255,1359,2614
448901,52031,Sarteano,2227,2437,4664
449003,52032,Siena,24947,28990,53937
449105,52033,Sinalunga,6057,6457,12514
449207,52034,Sovicille,4836,5192,10028
449309,52035,Torrita di Siena,3538,3729,7267
449411,52036,Trequanda,616,612,1228
449513,52037,Montalcino,2841,3002,5843
449615,53001,Arcidosso,2089,2190,4279
449717,53002,Campagnatico,1201,1168,2369
449819,53003,Capalbio,1976,2092,4068
449921,53004,Castel del Piano,2372,2436,4808
450023,53005,Castell'Azzara,674,734,1408
450125,53006,Castiglione della Pescaia,3546,3656,7202
450227,53007,Cinigiano,1227,1247,2474
450329,53008,Civitella Paganico,1587,1567,3154
450431,53009,Follonica,9895,11211,21106
450533,53010,Gavorrano,4221,4284,8505
450635,53011,Grosseto,39370,42983,82353
450737,53012,Isola del Giglio,757,679,1436
450839,53013,Magliano in Toscana,1666,1786,3452
450941,53014,Manciano,3474,3736,7210
451043,53015,Massa Marittima,3948,4355,8303
451145,53016,Monte Argentario,6038,6359,12397
451247,53017,Montieri,604,574,1178
451349,53018,Orbetello,6970,7761,14731
451451,53019,Pitigliano,1781,1963,3744
451553,53020,Roccalbegna,490,477,967
451655,53021,Roccastrada,4405,4605,9010
451757,53022,Santa Fiora,1254,1306,2560
451859,53023,Scansano,2211,2165,4376
451961,53024,Scarlino,1962,1954,3916
452063,53025,Seggiano,481,500,981
452165,53026,Sorano,1600,1665,3265
452267,53027,Monterotondo Marittimo,677,639,1316
452369,53028,Semproniano,517,544,1061
452471,54001,Assisi,13647,14667,28314
452573,54002,Bastia Umbra,10518,11263,21781
452675,54003,Bettona,2105,2242,4347
452777,54004,Bevagna,2449,2506,4955
452879,54005,Campello sul Clitunno,1146,1208,2354
452981,54006,Cannara,2116,2239,4355
453083,54007,Cascia,1545,1554,3099
453185,54008,Castel Ritaldi,1566,1643,3209
453287,54009,Castiglione del Lago,7476,7947,15423
453389,54010,Cerreto di Spoleto,502,536,1038
453491,54011,Citerna,1707,1725,3432
453593,54012,Città della Pieve,3679,4030,7709
453695,54013,Città di Castello,18849,20590,39439
453797,54014,Collazzone,1671,1777,3448
453899,54015,Corciano,10317,11074,21391
454001,54016,Costacciaro,566,593,1159
454103,54017,Deruta,4742,4963,9705
454205,54018,Foligno,27100,29959,57059
454307,54019,Fossato di Vico,1325,1383,2708
454409,54020,Fratta Todina,895,960,1855
454511,54021,Giano dell'Umbria,1959,1899,3858
454613,54022,Gualdo Cattaneo,2975,2917,5892
454715,54023,Gualdo Tadino,7104,7845,14949
454817,54024,Gubbio,15272,16275,31547
454919,54025,Lisciano Niccone,294,308,602
455021,54026,Magione,7185,7617,14802
455123,54027,Marsciano,9061,9513,18574
455225,54028,Massa Martana,1854,1819,3673
455327,54029,Monte Castello di Vibio,756,758,1514
455429,54030,Montefalco,2728,2807,5535
455531,54031,Monteleone di Spoleto,303,279,582
455633,54032,Monte Santa Maria Tiberina,570,586,1156
455735,54033,Montone,772,846,1618
455837,54034,Nocera Umbra,2780,2892,5672
455939,54035,Norcia,2397,2418,4815
456041,54036,Paciano,472,507,979
456143,54037,Panicale,2649,2866,5515
456245,54038,Passignano sul Trasimeno,2776,2896,5672
456347,54039,Perugia,79527,86429,165956
456449,54040,Piegaro,1726,1823,3549
456551,54041,Pietralunga,1009,1048,2057
456653,54042,Poggiodomo,55,45,100
456755,54043,Preci,353,347,700
456857,54044,San Giustino,5460,5767,11227
456959,54045,Sant'Anatolia di Narco,303,260,563
457061,54046,Scheggia e Pascelupo,671,662,1333
457163,54047,Scheggino,230,233,463
457265,54048,Sellano,508,519,1027
457367,54049,Sigillo,1156,1210,2366
457469,54050,Spello,4081,4484,8565
457571,54051,Spoleto,18336,19519,37855
457673,54052,Todi,7933,8501,16434
457775,54053,Torgiano,3222,3385,6607
457877,54054,Trevi,4078,4271,8349
457979,54055,Tuoro sul Trasimeno,1813,1973,3786
458081,54056,Umbertide,8087,8558,16645
458183,54057,Valfabbrica,1663,1698,3361
458285,54058,Vallo di Nera,171,182,353
458387,54059,Valtopina,663,688,1351
458489,55001,Acquasparta,2250,2420,4670
458591,55002,Allerona,857,906,1763
458693,55003,Alviano,686,752,1438
458795,55004,Amelia,5771,6048,11819
458897,55005,Arrone,1315,1400,2715
458999,55006,Attigliano,970,1008,1978
459101,55007,Baschi,1302,1371,2673
459203,55008,Calvi dell'Umbria,861,923,1784
459305,55009,Castel Giorgio,980,1125,2105
459407,55010,Castel Viscardo,1386,1475,2861
459509,55011,Fabro,1352,1400,2752
459611,55012,Ferentillo,922,937,1859
459713,55013,Ficulle,815,803,1618
459815,55014,Giove,911,986,1897
459917,55015,Guardea,881,899,1780
460019,55016,Lugnano in Teverina,721,713,1434
460121,55017,Montecastrilli,2484,2571,5055
460223,55018,Montecchio,800,840,1640
460325,55019,Montefranco,638,645,1283
460427,55020,Montegabbione,594,597,1191
460529,55021,Monteleone d'Orvieto,679,755,1434
460631,55022,Narni,9112,9943,19055
460733,55023,Orvieto,9583,10565,20148
460835,55024,Otricoli,878,920,1798
460937,55025,Parrano,242,263,505
461039,55026,Penna in Teverina,521,547,1068
461141,55027,Polino,117,109,226
461243,55028,Porano,919,1026,1945
461345,55029,San Gemini,2381,2557,4938
461447,55030,San Venanzo,1120,1078,2198
461549,55031,Stroncone,2384,2397,4781
461651,55032,Terni,52255,58494,110749
461753,55033,Avigliano Umbro,1259,1214,2473
461855,56001,Acquapendente,2653,2781,5434
461957,56002,Arlena di Castro,442,413,855
462059,56003,Bagnoregio,1727,1870,3597
462161,56004,Barbarano Romano,535,534,1069
462263,56005,Bassano Romano,2388,2403,4791
462365,56006,Bassano in Teverina,632,636,1268
462467,56007,Blera,1618,1637,3255
462569,56008,Bolsena,1874,2043,3917
462671,56009,Bomarzo,910,885,1795
462773,56010,Calcata,448,462,910
462875,56011,Canepina,1501,1518,3019
462977,56012,Canino,2668,2618,5286
463079,56013,Capodimonte,832,862,1694
463181,56014,Capranica,3137,3305,6442
463283,56015,Caprarola,2628,2738,5366
463385,56016,Carbognano,943,1028,1971
463487,56017,Castel Sant'Elia,1284,1310,2594
463589,56018,Castiglione in Teverina,1133,1186,2319
463691,56019,Celleno,636,672,1308
463793,56020,Cellere,561,581,1142
463895,56021,Civita Castellana,7838,8333,16171
463997,56022,Civitella d'Agliano,761,811,1572
464099,56023,Corchiano,1876,1862,3738
464201,56024,Fabrica di Roma,4112,4163,8275
464303,56025,Faleria,1072,1078,2150
464405,56026,Farnese,707,759,1466
464507,56027,Gallese,1356,1460,2816
464609,56028,Gradoli,646,677,1323
464711,56029,Graffignano,1096,1108,2204
464813,56030,Grotte di Castro,1305,1300,2605
464915,56031,Ischia di Castro,1081,1178,2259
465017,56032,Latera,428,383,811
465119,56033,Lubriano,432,463,895
465221,56034,Marta,1634,1761,3395
465323,56035,Montalto di Castro,4477,4488,8965
465425,56036,Montefiascone,6495,6892,13387
465527,56037,Monte Romano,982,984,1966
465629,56038,Monterosi,2333,2304,4637
465731,56039,Nepi,4665,4829,9494
465833,56040,Onano,489,487,976
465935,56041,Oriolo Romano,1910,1909,3819
466037,56042,Orte,4317,4525,8842
466139,56043,Piansano,1009,963,1972
466241,56044,Proceno,306,267,573
466343,56045,Ronciglione,4240,4293,8533
466445,56046,Villa San Giovanni in Tuscia,617,636,1253
466547,56047,San Lorenzo Nuovo,1042,1065,2107
466649,56048,Soriano nel Cimino,3998,4176,8174
466751,56049,Sutri,3300,3363,6663
466853,56050,Tarquinia,7844,8396,16240
466955,56051,Tessennano,169,154,323
467057,56052,Tuscania,4047,4317,8364
467159,56053,Valentano,1417,1425,2842
467261,56054,Vallerano,1257,1291,2548
467363,56055,Vasanello,1960,2048,4008
467465,56056,Vejano,1092,1126,2218
467567,56057,Vetralla,6821,7157,13978
467669,56058,Vignanello,2247,2264,4511
467771,56059,Viterbo,32714,34967,67681
467873,56060,Vitorchiano,2585,2659,5244
467975,57001,Accumoli,318,294,612
468077,57002,Amatrice,1320,1164,2484
468179,57003,Antrodoco,1258,1217,2475
468281,57004,Ascrea,131,109,240
468383,57005,Belmonte in Sabina,317,299,616
468485,57006,Borbona,304,297,601
468587,57007,Borgorose,2292,2143,4435
468689,57008,Borgo Velino,443,502,945
468791,57009,Cantalice,1305,1319,2624
468893,57010,Cantalupo in Sabina,826,840,1666
468995,57011,Casaprota,365,369,734
469097,57012,Casperia,595,655,1250
469199,57013,Castel di Tora,152,120,272
469301,57014,Castelnuovo di Farfa,515,516,1031
469403,57015,Castel Sant'Angelo,660,650,1310
469505,57016,Cittaducale,3275,3427,6702
469607,57017,Cittareale,240,205,445
469709,57018,Collalto Sabino,206,194,400
469811,57019,Colle di Tora,190,169,359
469913,57020,Collegiove,84,68,152
470015,57021,Collevecchio,768,776,1544
470117,57022,Colli sul Velino,242,255,497
470219,57023,Concerviano,127,144,271
470321,57024,Configni,293,288,581
470423,57025,Contigliano,1939,1957,3896
470525,57026,Cottanello,290,246,536
470627,57027,Fara in Sabina,6853,7027,13880
470729,57028,Fiamignano,677,622,1299
470831,57029,Forano,1603,1566,3169
470933,57030,Frasso Sabino,359,365,724
471035,57031,Greccio,762,788,1550
471137,57032,Labro,170,191,361
471239,57033,Leonessa,1174,1154,2328
471341,57034,Longone Sabino,281,273,554
471443,57035,Magliano Sabina,1800,1892,3692
471545,57036,Marcetelli,39,34,73
471647,57037,Micigliano,71,59,130
471749,57038,Mompeo,242,256,498
471851,57039,Montasola,211,180,391
471953,57040,Montebuono,441,435,876
472055,57041,Monteleone Sabino,588,610,1198
472157,57042,Montenero Sabino,148,139,287
472259,57043,Monte San Giovanni in Sabina,350,322,672
472361,57044,Montopoli di Sabina,2017,2057,4074
472463,57045,Morro Reatino,173,170,343
472565,57046,Nespolo,115,97,212
472667,57047,Orvinio,208,175,383
472769,57048,Paganico Sabino,84,82,166
472871,57049,Pescorocchiano,1024,994,2018
472973,57050,Petrella Salto,605,525,1130
473075,57051,Poggio Bustone,1011,1004,2015
473177,57052,Poggio Catino,619,653,1272
473279,57053,Poggio Mirteto,3137,3273,6410
473381,57054,Poggio Moiano,1312,1354,2666
473483,57055,Poggio Nativo,1306,1243,2549
473585,57056,Poggio San Lorenzo,285,253,538
473687,57057,Posta,338,297,635
473789,57058,Pozzaglia Sabina,162,161,323
473891,57059,Rieti,22570,24579,47149
473993,57060,Rivodutri,595,604,1199
474095,57061,Roccantica,271,282,553
474197,57062,Rocca Sinibalda,409,369,778
474299,57063,Salisano,262,287,549
474401,57064,Scandriglia,1624,1524,3148
474503,57065,Selci,542,558,1100
474605,57066,Stimigliano,1137,1149,2286
474707,57067,Tarano,691,729,1420
474809,57068,Toffia,517,502,1019
474911,57069,Torricella in Sabina,687,652,1339
475013,57070,Torri in Sabina,633,592,1225
475115,57071,Turania,136,94,230
475217,57072,Vacone,119,118,237
475319,57073,Varco Sabino,94,83,177
475421,58001,Affile,729,753,1482
475523,58002,Agosta,852,881,1733
475625,58003,Albano Laziale,19673,21307,40980
475727,58004,Allumiere,1977,2043,4020
475829,58005,Anguillara Sabazia,9549,9910,19459
475931,58006,Anticoli Corrado,427,434,861
476033,58007,Anzio,27295,27806,55101
476135,58008,Arcinazzo Romano,650,659,1309
476237,58009,Ariccia,8920,9654,18574
476339,58010,Arsoli,701,795,1496
476441,58011,Artena,6994,7092,14086
476543,58012,Bellegra,1370,1448,2818
476645,58013,Bracciano,9178,9899,19077
476747,58014,Camerata Nuova,232,212,444
476849,58015,Campagnano di Roma,5574,5959,11533
476951,58016,Canale Monterano,1982,2111,4093
477053,58017,Canterano,158,167,325
477155,58018,Capena,5518,5385,10903
477257,58019,Capranica Prenestina,184,153,337
477359,58020,Carpineto Romano,2104,2218,4322
477461,58021,Casape,326,353,679
477563,58022,Castel Gandolfo,4258,4697,8955
477665,58023,Castel Madama,3667,3671,7338
477767,58024,Castelnuovo di Porto,4308,4418,8726
477869,58025,Castel San Pietro Romano,406,447,853
477971,58026,Cave,5670,5758,11428
478073,58027,Cerreto Laziale,535,562,1097
478175,58028,Cervara di Roma,239,197,436
478277,58029,Cerveteri,18720,19363,38083
478379,58030,Ciciliano,666,641,1307
478481,58031,Cineto Romano,291,307,598
478583,58032,Civitavecchia,25192,27524,52716
478685,58033,Civitella San Paolo,1028,1004,2032
478787,58034,Colleferro,10261,11049,21310
478889,58035,Colonna,2105,2242,4347
478991,58036,Fiano Romano,7979,7879,15858
479093,58037,Filacciano,218,230,448
479195,58038,Formello,6329,6836,13165
479297,58039,Frascati,10790,11867,22657
479399,58040,Gallicano nel Lazio,3174,3116,6290
479501,58041,Gavignano,963,947,1910
479603,58042,Genazzano,2909,2955,5864
479705,58043,Genzano di Roma,11502,12212,23714
479807,58044,Gerano,615,615,1230
479909,58045,Gorga,346,360,706
480011,58046,Grottaferrata,9584,10983,20567
480113,58047,Guidonia Montecelio,44381,45290,89671
480215,58048,Jenne,170,182,352
480317,58049,Labico,3218,3296,6514
480419,58050,Lanuvio,6746,6793,13539
480521,58051,Licenza,471,470,941
480623,58052,Magliano Romano,715,687,1402
480725,58053,Mandela,461,461,922
480827,58054,Manziana,3764,3989,7753
480929,58055,Marano Equo,395,380,775
481031,58056,Marcellina,3560,3595,7155
481133,58057,Marino,21813,23168,44981
481235,58058,Mazzano Romano,1558,1580,3138
481337,58059,Mentana,11463,11727,23190
481439,58060,Monte Compatri,6021,6179,12200
481541,58061,Monteflavio,591,678,1269
481643,58062,Montelanico,1017,1074,2091
481745,58063,Montelibretti,2534,2748,5282
481847,58064,Monte Porzio Catone,4205,4553,8758
481949,58065,Monterotondo,19941,21346,41287
482051,58066,Montorio Romano,949,948,1897
482153,58067,Moricone,1268,1285,2553
482255,58068,Morlupo,4211,4469,8680
482357,58069,Nazzano,703,688,1391
482459,58070,Nemi,972,959,1931
482561,58071,Nerola,963,984,1947
482663,58072,Nettuno,24836,25159,49995
482765,58073,Olevano Romano,3262,3352,6614
482867,58074,Palestrina,10805,11260,22065
482969,58075,Palombara Sabina,6508,6670,13178
483071,58076,Percile,112,105,217
483173,58077,Pisoniano,357,394,751
483275,58078,Poli,1160,1180,2340
483377,58079,Pomezia,31755,32037,63792
483479,58080,Ponzano Romano,589,566,1155
483581,58081,Riano,5331,5356,10687
483683,58082,Rignano Flaminio,5028,5363,10391
483785,58083,Riofreddo,367,373,740
483887,58084,Rocca Canterano,96,86,182
483989,58085,Rocca di Cave,189,175,364
484091,58086,Rocca di Papa,8598,8687,17285
484193,58087,Roccagiovine,125,130,255
484295,58088,Rocca Priora,6131,6039,12170
484397,58089,Rocca Santo Stefano,485,467,952
484499,58090,Roiate,340,351,691
484601,58091,Roma,1351944,1504189,2856133
484703,58092,Roviano,639,707,1346
484805,58093,Sacrofano,3852,3999,7851
484907,58094,Sambuci,425,450,875
485009,58095,San Gregorio da Sassola,788,771,1559
485111,58096,San Polo dei Cavalieri,1427,1412,2839
485213,58097,Santa Marinella,9156,9777,18933
485315,58098,Sant'Angelo Romano,2482,2513,4995
485417,58099,Sant'Oreste,1830,1826,3656
485519,58100,San Vito Romano,1649,1654,3303
485621,58101,Saracinesco,97,78,175
485723,58102,Segni,4441,4693,9134
485825,58103,Subiaco,4412,4490,8902
485927,58104,Tivoli,27565,28907,56472
486029,58105,Tolfa,2527,2455,4982
486131,58106,Torrita Tiberina,529,544,1073
486233,58107,Trevignano Romano,2760,2938,5698
486335,58108,Vallepietra,127,132,259
486437,58109,Vallinfreda,155,143,298
486539,58110,Valmontone,8004,8173,16177
486641,58111,Velletri,25937,27313,53250
486743,58112,Vicovaro,1933,1972,3905
486845,58113,Vivaro Romano,84,77,161
486947,58114,Zagarolo,9108,8973,18081
487049,58115,Lariano,6640,6827,13467
487151,58116,Ladispoli,20315,21269,41584
487253,58117,Ardea,25203,24547,49750
487355,58118,Ciampino,18569,20394,38963
487457,58119,San Cesareo,7880,7921,15801
487559,58120,Fiumicino,39965,40505,80470
487661,58122,Fonte Nuova,16484,16926,33410
487763,59001,Aprilia,36928,37732,74660
487865,59002,Bassiano,772,736,1508
487967,59003,Campodimele,323,282,605
488069,59004,Castelforte,2009,2180,4189
488171,59005,Cisterna di Latina,18399,18731,37130
488273,59006,Cori,5361,5497,10858
488375,59007,Fondi,19867,19959,39826
488477,59008,Formia,18259,19846,38105
488579,59009,Gaeta,9787,10574,20361
488681,59010,Itri,5485,5321,10806
488783,59011,Latina,61708,65038,126746
488885,59012,Lenola,2062,2121,4183
488987,59013,Maenza,1534,1562,3096
489089,59014,Minturno,9683,10043,19726
489191,59015,Monte San Biagio,3193,3093,6286
489293,59016,Norma,1883,1993,3876
489395,59017,Pontinia,7500,7445,14945
489497,59018,Ponza,1743,1633,3376
489599,59019,Priverno,6993,7303,14296
489701,59020,Prossedi,627,579,1206
489803,59021,Roccagorga,2136,2222,4358
489905,59022,Rocca Massima,571,530,1101
490007,59023,Roccasecca dei Volsci,592,561,1153
490109,59024,Sabaudia,10581,9883,20464
490211,59025,San Felice Circeo,5238,4896,10134
490313,59026,Santi Cosma e Damiano,3433,3510,6943
490415,59027,Sermoneta,5106,5029,10135
490517,59028,Sezze,12481,12430,24911
490619,59029,Sonnino,3782,3776,7558
490721,59030,Sperlonga,1604,1625,3229
490823,59031,Spigno Saturnia,1413,1502,2915
490925,59032,Terracina,23056,22744,45800
491027,59033,Ventotene,417,352,769
491129,60001,Acquafondata,137,129,266
491231,60002,Acuto,925,951,1876
491333,60003,Alatri,14099,14533,28632
491435,60004,Alvito,1312,1334,2646
491537,60005,Amaseno,2157,2156,4313
491639,60006,Anagni,10460,10789,21249
491741,60007,Aquino,2523,2643,5166
491843,60008,Arce,2781,2852,5633
491945,60009,Arnara,1076,1202,2278
492047,60010,Arpino,3453,3640,7093
492149,60011,Atina,2062,2185,4247
492251,60012,Ausonia,1272,1305,2577
492353,60013,Belmonte Castello,357,341,698
492455,60014,Boville Ernica,4213,4313,8526
492557,60015,Broccostella,1331,1401,2732
492659,60016,Campoli Appennino,832,841,1673
492761,60017,Casalattico,260,286,546
492863,60018,Casalvieri,1313,1322,2635
492965,60019,Cassino,18071,18541,36612
493067,60020,Castelliri,1692,1699,3391
493169,60021,Castelnuovo Parano,432,443,875
493271,60022,Castrocielo,1951,2028,3979
493373,60023,Castro dei Volsci,2281,2421,4702
493475,60024,Ceccano,11361,11883,23244
493577,60025,Ceprano,4375,4476,8851
493679,60026,Cervaro,3945,4119,8064
493781,60027,Colfelice,938,956,1894
493883,60028,Collepardo,473,458,931
493985,60029,Colle San Magno,335,329,664
494087,60030,Coreno Ausonio,790,812,1602
494189,60031,Esperia,1920,1921,3841
494291,60032,Falvaterra,284,261,545
494393,60033,Ferentino,10396,10577,20973
494495,60034,Filettino,273,249,522
494597,60035,Fiuggi,5260,5443,10703
494699,60036,Fontana Liri,1412,1456,2868
494801,60037,Fontechiari,609,686,1295
494903,60038,Frosinone,22043,24011,46054
495005,60039,Fumone,1024,1068,2092
495107,60040,Gallinaro,612,663,1275
495209,60041,Giuliano di Roma,1199,1214,2413
495311,60042,Guarcino,779,774,1553
495413,60043,Isola del Liri,5471,5921,11392
495515,60044,Monte San Giovanni Campano,6312,6284,12596
495617,60045,Morolo,1653,1604,3257
495719,60046,Paliano,4045,4143,8188
495821,60047,Pastena,684,693,1377
495923,60048,Patrica,1572,1579,3151
496025,60049,Pescosolido,760,745,1505
496127,60050,Picinisco,536,591,1127
496229,60051,Pico,1384,1428,2812
496331,60052,Piedimonte San Germano,3221,3265,6486
496433,60053,Piglio,2267,2314,4581
496535,60054,Pignataro Interamna,1215,1284,2499
496637,60055,Pofi,2061,2042,4103
496739,60056,Pontecorvo,6406,6621,13027
496841,60057,Posta Fibreno,534,570,1104
496943,60058,Ripi,2590,2651,5241
497045,60059,Rocca d'Arce,479,469,948
497147,60060,Roccasecca,3727,3681,7408
497249,60061,San Biagio Saracinisco,156,163,319
497351,60062,San Donato Val di Comino,956,1048,2004
497453,60063,San Giorgio a Liri,1538,1607,3145
497555,60064,San Giovanni Incarico,1639,1641,3280
497657,60065,Sant'Ambrogio sul Garigliano,508,456,964
497759,60066,Sant'Andrea del Garigliano,718,714,1432
497861,60067,Sant'Apollinare,916,966,1882
497963,60068,Sant'Elia Fiumerapido,2994,3008,6002
498065,60069,Santopadre,649,648,1297
498167,60070,San Vittore del Lazio,1290,1281,2571
498269,60071,Serrone,1537,1495,3032
498371,60072,Settefrati,355,374,729
498473,60073,Sgurgola,1251,1346,2597
498575,60074,Sora,12644,13312,25956
498677,60075,Strangolagalli,1168,1231,2399
498779,60076,Supino,2379,2418,4797
498881,60077,Terelle,166,187,353
498983,60078,Torre Cajetani,674,664,1338
499085,60079,Torrice,2380,2434,4814
499187,60080,Trevi nel Lazio,940,869,1809
499289,60081,Trivigliano,815,850,1665
499391,60082,Vallecorsa,1250,1288,2538
499493,60083,Vallemaio,455,469,924
499595,60084,Vallerotonda,754,761,1515
499697,60085,Veroli,10112,10312,20424
499799,60086,Vicalvi,362,393,755
499901,60087,Vico nel Lazio,1082,1111,2193
500003,60088,Villa Latina,601,602,1203
500105,60089,Villa Santa Lucia,1298,1307,2605
500207,60090,Villa Santo Stefano,835,866,1701
500309,60091,Viticuso,150,159,309
500411,61001,Ailano,600,708,1308
500513,61002,Alife,3840,3816,7656
500615,61003,Alvignano,2311,2415,4726
500717,61004,Arienzo,2631,2705,5336
500819,61005,Aversa,25363,27245,52608
500921,61006,Baia e Latina,1043,1083,2126
501023,61007,Bellona,3012,3116,6128
501125,61008,Caianello,940,935,1875
501227,61009,Caiazzo,2650,2784,5434
501329,61010,Calvi Risorta,2794,2893,5687
501431,61011,Camigliano,985,1011,1996
501533,61012,Cancello ed Arnone,2886,2793,5679
501635,61013,Capodrise,5026,5142,10168
501737,61014,Capriati a Volturno,719,810,1529
501839,61015,Capua,8830,9463,18293
501941,61016,Carinaro,3441,3631,7072
502043,61017,Carinola,3672,3670,7342
502145,61018,Casagiove,6575,7013,13588
502247,61019,Casal di Principe,10701,10741,21442
502349,61020,Casaluce,4858,5050,9908
502451,61021,Casapulla,4162,4381,8543
502553,61022,Caserta,35409,40021,75430
502655,61023,Castel Campagnano,713,788,1501
502757,61024,Castel di Sasso,558,575,1133
502859,61025,Castello del Matese,686,745,1431
502961,61026,Castel Morrone,1792,1947,3739
503063,61027,Castel Volturno,13228,12695,25923
503165,61028,Cervino,2453,2567,5020
503267,61029,Cesa,4597,4610,9207
503369,61030,Ciorlano,201,208,409
503471,61031,Conca della Campania,587,610,1197
503573,61032,Curti,3327,3712,7039
503675,61033,Dragoni,1014,1091,2105
503777,61034,Fontegreca,395,397,792
503879,61035,Formicola,682,776,1458
503981,61036,Francolise,2396,2392,4788
504083,61037,Frignano,4500,4653,9153
504185,61038,Gallo Matese,269,258,527
504287,61039,Galluccio,1050,1056,2106
504389,61040,Giano Vetusto,318,336,654
504491,61041,Gioia Sannitica,1748,1785,3533
504593,61042,Grazzanise,3485,3536,7021
504695,61043,Gricignano di Aversa,6218,6245,12463
504797,61044,Letino,334,364,698
504899,61045,Liberi,530,597,1127
505001,61046,Lusciano,7699,8059,15758
505103,61047,Macerata Campania,5083,5300,10383
505205,61048,Maddaloni,19082,19833,38915
505307,61049,Marcianise,19338,20238,39576
505409,61050,Marzano Appio,1087,1096,2183
505511,61051,Mignano Monte Lungo,1535,1586,3121
505613,61052,Mondragone,14482,14589,29071
505715,61053,Orta di Atella,13679,13728,27407
505817,61054,Parete,5849,5943,11792
505919,61055,Pastorano,1495,1528,3023
506021,61056,Piana di Monte Verna,1165,1137,2302
506123,61057,Piedimonte Matese,5213,5622,10835
506225,61058,Pietramelara,2247,2416,4663
506327,61059,Pietravairano,1424,1525,2949
506429,61060,Pignataro Maggiore,2821,3057,5878
506531,61061,Pontelatone,799,847,1646
506633,61062,Portico di Caserta,3907,3998,7905
506735,61063,Prata Sannita,692,757,1449
506837,61064,Pratella,736,785,1521
506939,61065,Presenzano,923,873,1796
507041,61066,Raviscanina,625,663,1288
507143,61067,Recale,3818,3847,7665
507245,61068,Riardo,1118,1195,2313
507347,61069,Rocca d'Evandro,1554,1580,3134
507449,61070,Roccamonfina,1650,1709,3359
507551,61071,Roccaromana,403,444,847
507653,61072,Rocchetta e Croce,221,226,447
507755,61073,Ruviano,755,844,1599
507857,61074,San Cipriano d'Aversa,6817,6832,13649
507959,61075,San Felice a Cancello,8538,8857,17395
508061,61076,San Gregorio Matese,462,473,935
508163,61077,San Marcellino,7253,7144,14397
508265,61078,San Nicola la Strada,11198,11417,22615
508367,61079,San Pietro Infine,463,460,923
508469,61080,San Potito Sannitico,937,973,1910
508571,61081,San Prisco,5985,6387,12372
508673,61082,Santa Maria a Vico,6850,7153,14003
508775,61083,Santa Maria Capua Vetere,15468,17259,32727
508877,61084,Santa Maria la Fossa,1296,1353,2649
508979,61085,San Tammaro,2769,2717,5486
509081,61086,Sant'Angelo d'Alife,1083,1148,2231
509183,61087,Sant'Arpino,7359,7430,14789
509285,61088,Sessa Aurunca,10359,10795,21154
509387,61089,Sparanise,3526,3792,7318
509489,61090,Succivo,4275,4317,8592
509591,61091,Teano,5989,6252,12241
509693,61092,Teverola,7247,7388,14635
509795,61093,Tora e Piccilli,409,454,863
509897,61094,Trentola Ducenta,9864,10172,20036
509999,61095,Vairano Patenora,3198,3343,6541
510101,61096,Valle Agricola,400,435,835
510203,61097,Valle di Maddaloni,1322,1397,2719
510305,61098,Villa di Briano,3608,3592,7200
510407,61099,Villa Literno,6335,5989,12324
510509,61100,Vitulazio,3685,3854,7539
510611,61101,Falciano del Massico,1710,1851,3561
510713,61102,Cellole,3885,4109,7994
510815,61103,Casapesenna,3456,3566,7022
510917,61104,San Marco Evangelista,3256,3331,6587
511019,62001,Airola,4175,4178,8353
511121,62002,Amorosi,1334,1393,2727
511223,62003,Apice,2749,2829,5578
511325,62004,Apollosa,1326,1342,2668
511427,62005,Arpaia,999,1001,2000
511529,62006,Arpaise,387,372,759
511631,62007,Baselice,1090,1176,2266
511733,62008,Benevento,28244,30956,59200
511835,62009,Bonea,694,692,1386
511937,62010,Bucciano,1043,1063,2106
512039,62011,Buonalbergo,823,828,1651
512141,62012,Calvi,1296,1331,2627
512243,62013,Campolattaro,498,514,1012
512345,62014,Campoli del Monte Taburno,906,751,1657
512447,62015,Casalduni,651,650,1301
512549,62016,Castelfranco in Miscano,440,433,873
512651,62017,Castelpagano,725,722,1447
512753,62018,Castelpoto,585,616,1201
512855,62019,Castelvenere,1335,1326,2661
512957,62020,Castelvetere in Val Fortore,536,594,1130
513059,62021,Cautano,1037,990,2027
513161,62022,Ceppaloni,1660,1686,3346
513263,62023,Cerreto Sannita,1870,1942,3812
513365,62024,Circello,1129,1170,2299
513467,62025,Colle Sannita,1158,1210,2368
513569,62026,Cusano Mutri,2003,1979,3982
513671,62027,Dugenta,1372,1416,2788
513773,62028,Durazzano,1104,1074,2178
513875,62029,Faicchio,1753,1841,3594
513977,62030,Foglianise,1602,1656,3258
514079,62031,Foiano di Val Fortore,680,724,1404
514181,62032,Forchia,623,600,1223
514283,62033,Fragneto l'Abate,483,527,1010
514385,62034,Fragneto Monforte,879,914,1793
514487,62035,Frasso Telesino,1080,1144,2224
514589,62036,Ginestra degli Schiavoni,232,232,464
514691,62037,Guardia Sanframondi,2413,2473,4886
514793,62038,Limatola,2106,2052,4158
514895,62039,Melizzano,895,911,1806
514997,62040,Moiano,1987,2115,4102
515099,62041,Molinara,787,800,1587
515201,62042,Montefalcone di Val Fortore,660,769,1429
515303,62043,Montesarchio,6672,6864,13536
515405,62044,Morcone,2360,2468,4828
515507,62045,Paduli,1920,1943,3863
515609,62046,Pago Veiano,1174,1220,2394
515711,62047,Pannarano,1111,1033,2144
515813,62048,Paolisi,1064,1018,2082
515915,62049,Paupisi,825,803,1628
516017,62050,Pesco Sannita,920,1016,1936
516119,62051,Pietraroja,238,284,522
516221,62052,Pietrelcina,1545,1502,3047
516323,62053,Ponte,1229,1321,2550
516425,62054,Pontelandolfo,1039,1080,2119
516527,62055,Puglianello,669,663,1332
516629,62056,Reino,580,582,1162
516731,62057,San Bartolomeo in Galdo,2274,2370,4644
516833,62058,San Giorgio del Sannio,4833,5215,10048
516935,62059,San Giorgio La Molara,1487,1459,2946
517037,62060,San Leucio del Sannio,1533,1550,3083
517139,62061,San Lorenzello,1091,1100,2191
517241,62062,San Lorenzo Maggiore,1067,1031,2098
517343,62063,San Lupo,386,383,769
517445,62064,San Marco dei Cavoti,1561,1664,3225
517547,62065,San Martino Sannita,630,629,1259
517649,62066,San Nazzaro,441,444,885
517751,62067,San Nicola Manfredi,1844,1833,3677
517853,62068,San Salvatore Telesino,1987,2069,4056
517955,62069,Santa Croce del Sannio,449,437,886
518057,62070,Sant'Agata de' Goti,5540,5488,11028
518159,62071,Sant'Angelo a Cupolo,2114,2156,4270
518261,62072,Sassinoro,294,320,614
518363,62073,Solopaca,1718,2048,3766
518465,62074,Telese Terme,3747,3964,7711
518567,62075,Tocco Caudio,748,765,1513
518669,62076,Torrecuso,1718,1696,3414
518771,62077,Vitulano,1511,1420,2931
518873,62078,Sant'Arcangelo Trimonte,263,257,520
518975,63001,Acerra,28966,29847,58813
519077,63002,Afragola,31700,32743,64443
519179,63003,Agerola,3809,3939,7748
519281,63004,Anacapri,3443,3575,7018
519383,63005,Arzano,16675,17390,34065
519485,63006,Bacoli,12864,13381,26245
519587,63007,Barano d'Ischia,4910,5067,9977
519689,63008,Boscoreale,13752,14112,27864
519791,63009,Boscotrecase,4979,5232,10211
519893,63010,Brusciano,8022,8230,16252
519995,63011,Caivano,18524,19030,37554
520097,63012,Calvizzano,5716,6237,11953
520199,63013,Camposano,2528,2775,5303
520301,63014,Capri,3525,3619,7144
520403,63015,Carbonara di Nola,1226,1230,2456
520505,63016,Cardito,11094,11395,22489
520607,63017,Casalnuovo di Napoli,23877,25108,48985
520709,63018,Casamarciano,1587,1640,3227
520811,63019,Casamicciola Terme,3913,4171,8084
520913,63020,Casandrino,7334,6608,13942
521015,63021,Casavatore,9089,9570,18659
521117,63022,Casola di Napoli,1870,1943,3813
521219,63023,Casoria,37113,39678,76791
521321,63024,Castellammare di Stabia,31330,34245,65575
521423,63025,Castello di Cisterna,3920,4055,7975
521525,63026,Cercola,8670,9259,17929
521627,63027,Cicciano,6230,6632,12862
521729,63028,Cimitile,3409,3682,7091
521831,63029,Comiziano,865,899,1764
521933,63030,Crispano,6090,6160,12250
522035,63031,Forio,8950,9055,18005
522137,63032,Frattamaggiore,14408,15458,29866
522239,63033,Frattaminore,7918,8103,16021
522341,63034,Giugliano in Campania,61148,62342,123490
522443,63035,Gragnano,14179,14667,28846
522545,63036,Grumo Nevano,8966,8934,17900
522647,63037,Ischia,10044,10126,20170
522749,63038,Lacco Ameno,2297,2467,4764
522851,63039,Lettere,3159,3074,6233
522953,63040,Liveri,767,805,1572
523055,63041,Marano di Napoli,29309,30854,60163
523157,63042,Mariglianella,3920,4001,7921
523259,63043,Marigliano,14272,15455,29727
523361,63044,Massa Lubrense,7027,7253,14280
523463,63045,Melito di Napoli,18709,19194,37903
523565,63046,Meta,3780,4161,7941
523667,63047,Monte di Procida,6170,6504,12674
523769,63048,Mugnano di Napoli,17091,18054,35145
523871,63049,Napoli,458566,500622,959188
523973,63050,Nola,16737,17856,34593
524075,63051,Ottaviano,11543,12076,23619
524177,63052,Palma Campania,9021,7833,16854
524279,63053,Piano di Sorrento,6230,6731,12961
524381,63054,Pimonte,3016,3019,6035
524483,63055,Poggiomarino,11049,10987,22036
524585,63056,Pollena Trocchia,6461,6910,13371
524687,63057,Pomigliano d'Arco,18992,20645,39637
524789,63058,Pompei,12002,13085,25087
524891,63059,Portici,25348,28697,54045
524993,63060,Pozzuoli,39116,41735,80851
525095,63061,Procida,5179,5302,10481
525197,63062,Qualiano,12736,13030,25766
525299,63063,Quarto,20259,21092,41351
525401,63064,Ercolano,25470,26904,52374
525503,63065,Roccarainola,3336,3556,6892
525605,63066,San Gennaro Vesuviano,6180,5876,12056
525707,63067,San Giorgio a Cremano,21126,23562,44688
525809,63068,San Giuseppe Vesuviano,16772,15242,32014
525911,63069,San Paolo Bel Sito,1655,1750,3405
526013,63070,San Sebastiano al Vesuvio,4269,4711,8980
526115,63071,Sant'Agnello,4344,4723,9067
526217,63072,Sant'Anastasia,13283,14062,27345
526319,63073,Sant'Antimo,16530,17249,33779
526421,63074,Sant'Antonio Abate,9681,9974,19655
526523,63075,San Vitaliano,3109,3342,6451
526625,63076,Saviano,7927,8359,16286
526727,63077,Scisciano,2985,3160,6145
526829,63078,Serrara Fontana,1563,1563,3126
526931,63079,Somma Vesuviana,17103,17853,34956
527033,63080,Sorrento,7799,8521,16320
527135,63081,Striano,4350,4323,8673
527237,63082,Terzigno,9095,8971,18066
527339,63083,Torre Annunziata,20278,22024,42302
527441,63084,Torre del Greco,40835,43837,84672
527543,63085,Tufino,1793,1834,3627
527645,63086,Vico Equense,10122,10690,20812
527747,63087,Villaricca,15147,16035,31182
527849,63088,Visciano,2151,2228,4379
527951,63089,Volla,12237,12601,24838
528053,63090,Santa Maria la Carità,5818,5893,11711
528155,63091,Trecase,4359,4457,8816
528257,63092,Massa di Somma,2573,2722,5295
528359,64001,Aiello del Sabato,2013,2022,4035
528461,64002,Altavilla Irpina,2019,2093,4112
528563,64003,Andretta,870,942,1812
528665,64004,Aquilonia,851,784,1635
528767,64005,Ariano Irpino,10930,11316,22246
528869,64006,Atripalda,5236,5616,10852
528971,64007,Avella,3790,3980,7770
529073,64008,Avellino,25426,28601,54027
529175,64009,Bagnoli Irpino,1557,1579,3136
529277,64010,Baiano,2260,2415,4675
529379,64011,Bisaccia,1910,1898,3808
529481,64012,Bonito,1177,1186,2363
529583,64013,Cairano,145,153,298
529685,64014,Calabritto,1129,1189,2318
529787,64015,Calitri,2158,2348,4506
529889,64016,Candida,593,545,1138
529991,64017,Caposele,1664,1727,3391
530093,64018,Capriglia Irpina,1203,1194,2397
530195,64019,Carife,657,705,1362
530297,64020,Casalbore,858,885,1743
530399,64021,Cassano Irpino,478,467,945
530501,64022,Castel Baronia,543,559,1102
530603,64023,Castelfranci,948,1004,1952
530705,64024,Castelvetere sul Calore,784,796,1580
530807,64025,Cervinara,4603,4804,9407
530909,64026,Cesinali,1286,1316,2602
531011,64027,Chianche,250,230,480
531113,64028,Chiusano di San Domenico,1070,1129,2199
531215,64029,Contrada,1578,1466,3044
531317,64030,Conza della Campania,638,675,1313
531419,64031,Domicella,924,920,1844
531521,64032,Flumeri,1466,1460,2926
531623,64033,Fontanarosa,1484,1511,2995
531725,64034,Forino,2655,2724,5379
531827,64035,Frigento,1759,1812,3571
531929,64036,Gesualdo,1716,1745,3461
532031,64037,Greci,309,344,653
532133,64038,Grottaminarda,3940,4077,8017
532235,64039,Grottolella,953,943,1896
532337,64040,Guardia Lombardi,775,859,1634
532439,64041,Lacedonia,1106,1116,2222
532541,64042,Lapio,754,764,1518
532643,64043,Lauro,1664,1814,3478
532745,64044,Lioni,3033,3118,6151
532847,64045,Luogosano,613,546,1159
532949,64046,Manocalzati,1596,1570,3166
533051,64047,Marzano di Nola,827,867,1694
533153,64048,Melito Irpino,958,942,1900
533255,64049,Mercogliano,6026,6256,12282
533357,64050,Mirabella Eclano,3719,3817,7536
533459,64051,Montaguto,202,195,397
533561,64052,Montecalvo Irpino,1704,1860,3564
533663,64053,Montefalcione,1594,1679,3273
533765,64054,Monteforte Irpino,6102,5691,11793
533867,64055,Montefredane,1074,1120,2194
533969,64056,Montefusco,646,640,1286
534071,64057,Montella,3731,3939,7670
534173,64058,Montemarano,1361,1406,2767
534275,64059,Montemiletto,2601,2647,5248
534377,64060,Monteverde,372,375,747
534479,64063,Morra De Sanctis,577,635,1212
534581,64064,Moschiano,785,844,1629
534683,64065,Mugnano del Cardinale,2645,2593,5238
534785,64066,Nusco,1986,2148,4134
534887,64067,Ospedaletto d'Alpinolo,1050,1079,2129
534989,64068,Pago del Vallo di Lauro,886,911,1797
535091,64069,Parolise,325,335,660
535193,64070,Paternopoli,1131,1176,2307
535295,64071,Petruro Irpino,179,168,347
535397,64072,Pietradefusi,1148,1161,2309
535499,64073,Pietrastornina,758,737,1495
535601,64074,Prata di Principato Ultra,1511,1466,2977
535703,64075,Pratola Serra,1822,1918,3740
535805,64076,Quadrelle,926,952,1878
535907,64077,Quindici,964,930,1894
536009,64078,Roccabascerana,1169,1182,2351
536111,64079,Rocca San Felice,411,428,839
536213,64080,Rotondi,1835,1771,3606
536315,64081,Salza Irpina,368,372,740
536417,64082,San Mango sul Calore,595,562,1157
536519,64083,San Martino Valle Caudina,2388,2452,4840
536621,64084,San Michele di Serino,1244,1252,2496
536723,64085,San Nicola Baronia,371,391,762
536825,64086,San Potito Ultra,776,781,1557
536927,64087,San Sossio Baronia,780,818,1598
537029,64088,Santa Lucia di Serino,689,713,1402
537131,64089,Sant'Andrea di Conza,696,748,1444
537233,64090,Sant'Angelo all'Esca,399,370,769
537335,64091,Sant'Angelo a Scala,409,325,734
537437,64092,Sant'Angelo dei Lombardi,2178,1995,4173
537539,64093,Santa Paolina,594,630,1224
537641,64095,Santo Stefano del Sole,1034,1109,2143
537743,64096,Savignano Irpino,560,553,1113
537845,64097,Scampitella,549,610,1159
537947,64098,Senerchia,424,375,799
538049,64099,Serino,3492,3424,6916
538151,64100,Sirignano,1403,1433,2836
538253,64101,Solofra,6136,6291,12427
538355,64102,Sorbo Serpico,289,298,587
538457,64103,Sperone,1834,1945,3779
538559,64104,Sturno,1478,1534,3012
538661,64105,Summonte,773,781,1554
538763,64106,Taurano,741,767,1508
538865,64107,Taurasi,1140,1152,2292
538967,64108,Teora,735,739,1474
539069,64109,Torella dei Lombardi,1014,1033,2047
539171,64110,Torre Le Nocelle,612,634,1246
539273,64111,Torrioni,302,231,533
539375,64112,Trevico,453,469,922
539477,64113,Tufo,404,439,843
539579,64114,Vallata,1301,1363,2664
539681,64115,Vallesaccarda,641,662,1303
539783,64116,Venticano,1264,1242,2506
539885,64117,Villamaina,464,498,962
539987,64118,Villanova del Battista,758,834,1592
540089,64119,Volturara Irpina,1519,1665,3184
540191,64120,Zungoli,518,540,1058
540293,64121,Montoro,9905,9835,19740
540395,65001,Acerno,1350,1329,2679
540497,65002,Agropoli,10791,11039,21830
540599,65003,Albanella,3171,3239,6410
540701,65004,Alfano,485,515,1000
540803,65005,Altavilla Silentina,3468,3627,7095
540905,65006,Amalfi,2416,2609,5025
541007,65007,Angri,16694,17457,34151
541109,65008,Aquara,724,732,1456
541211,65009,Ascea,2948,2946,5894
541313,65010,Atena Lucana,1192,1207,2399
541415,65011,Atrani,410,432,842
541517,65012,Auletta,1115,1141,2256
541619,65013,Baronissi,8432,8709,17141
541721,65014,Battipaglia,25025,26030,51055
541823,65015,Bellosguardo,369,401,770
541925,65016,Bracigliano,2767,2768,5535
542027,65017,Buccino,2378,2455,4833
542129,65018,Buonabitacolo,1231,1299,2530
542231,65019,Caggiano,1333,1318,2651
542333,65020,Calvanico,732,752,1484
542435,65021,Camerota,3537,3610,7147
542537,65022,Campagna,8784,8441,17225
542639,65023,Campora,186,192,378
542741,65024,Cannalonga,509,508,1017
542843,65025,Capaccio Paestum,11489,11432,22921
542945,65026,Casalbuono,572,587,1159
543047,65027,Casaletto Spartano,657,705,1362
543149,65028,Casal Velino,2654,2682,5336
543251,65029,Caselle in Pittari,950,967,1917
543353,65030,Castelcivita,822,806,1628
543455,65031,Castellabate,4609,4664,9273
543557,65032,Castelnuovo Cilento,1369,1475,2844
543659,65033,Castelnuovo di Conza,306,289,595
543761,65034,Castel San Giorgio,6771,6929,13700
543863,65035,Castel San Lorenzo,1138,1239,2377
543965,65036,Castiglione del Genovesi,694,628,1322
544067,65037,Cava de' Tirreni,25603,27328,52931
544169,65038,Celle di Bulgheria,892,949,1841
544271,65039,Centola,2603,2497,5100
544373,65040,Ceraso,1136,1167,2303
544475,65041,Cetara,1014,1047,2061
544577,65042,Cicerale,587,602,1189
544679,65043,Colliano,1739,1822,3561
544781,65044,Conca dei Marini,352,335,687
544883,65045,Controne,425,439,864
544985,65046,Contursi Terme,1650,1671,3321
545087,65047,Corbara,1226,1281,2507
545189,65048,Corleto Monforte,271,273,544
545291,65049,Cuccaro Vetere,249,311,560
545393,65050,Eboli,20442,19542,39984
545495,65051,Felitto,572,646,1218
545597,65052,Fisciano,6922,7024,13946
545699,65053,Furore,398,354,752
545801,65054,Futani,537,623,1160
545903,65055,Giffoni Sei Casali,2503,2578,5081
546005,65056,Giffoni Valle Piana,5829,6044,11873
546107,65057,Gioi,569,660,1229
546209,65058,Giungano,654,673,1327
546311,65059,Ispani,505,484,989
546413,65060,Laureana Cilento,590,606,1196
546515,65061,Laurino,711,718,1429
546617,65062,Laurito,383,383,766
546719,65063,Laviano,668,710,1378
546821,65064,Lustra,521,517,1038
546923,65065,Magliano Vetere,317,341,658
547025,65066,Maiori,2721,2855,5576
547127,65067,Mercato San Severino,10898,11426,22324
547229,65068,Minori,1320,1378,2698
547331,65069,Moio della Civitella,901,967,1868
547433,65070,Montano Antilia,953,1032,1985
547535,65071,Montecorice,1389,1283,2672
547637,65072,Montecorvino Pugliano,5512,5426,10938
547739,65073,Montecorvino Rovella,6291,6258,12549
547841,65074,Monteforte Cilento,289,256,545
547943,65075,Monte San Giacomo,746,784,1530
548045,65076,Montesano sulla Marcellana,3182,3300,6482
548147,65077,Morigerati,323,328,651
548249,65078,Nocera Inferiore,22151,23457,45608
548351,65079,Nocera Superiore,11899,12351,24250
548453,65080,Novi Velia,1159,1126,2285
548555,65081,Ogliastro Cilento,1116,1128,2244
548657,65082,Olevano sul Tusciano,3323,3456,6779
548759,65083,Oliveto Citra,1820,1883,3703
548861,65084,Omignano,800,825,1625
548963,65085,Orria,527,523,1050
549065,65086,Ottati,289,313,602
549167,65087,Padula,2665,2687,5352
549269,65088,Pagani,17352,18186,35538
549371,65089,Palomonte,1962,1940,3902
549473,65090,Pellezzano,5467,5588,11055
549575,65091,Perdifumo,879,895,1774
549677,65092,Perito,435,451,886
549779,65093,Pertosa,332,348,680
549881,65094,Petina,553,554,1107
549983,65095,Piaggine,619,652,1271
550085,65096,Pisciotta,1268,1319,2587
550187,65097,Polla,2548,2757,5305
550289,65098,Pollica,1141,1193,2334
550391,65099,Pontecagnano Faiano,12911,13360,26271
550493,65100,Positano,1910,1988,3898
550595,65101,Postiglione,1029,1019,2048
550697,65102,Praiano,1004,1001,2005
550799,65103,Prignano Cilento,536,534,1070
550901,65104,Ravello,1209,1271,2480
551003,65105,Ricigliano,532,561,1093
551105,65106,Roccadaspide,3423,3642,7065
551207,65107,Roccagloriosa,838,841,1679
551309,65108,Roccapiemonte,4387,4574,8961
551411,65109,Rofrano,763,734,1497
551513,65110,Romagnano al Monte,172,209,381
551615,65111,Roscigno,361,335,696
551717,65112,Rutino,422,386,808
551819,65113,Sacco,223,245,468
551921,65114,Sala Consilina,6103,6449,12552
552023,65115,Salento,975,993,1968
552125,65116,Salerno,62363,71001,133364
552227,65117,Salvitelle,240,277,517
552329,65118,San Cipriano Picentino,3235,3356,6591
552431,65119,San Giovanni a Piro,1867,1892,3759
552533,65120,San Gregorio Magno,2032,2142,4174
552635,65121,San Mango Piemonte,1361,1387,2748
552737,65122,San Marzano sul Sarno,5224,5315,10539
552839,65123,San Mauro Cilento,440,408,848
552941,65124,San Mauro la Bruca,279,285,564
553043,65125,San Pietro al Tanagro,823,875,1698
553145,65126,San Rufo,846,858,1704
553247,65127,Santa Marina,1578,1658,3236
553349,65128,Sant'Angelo a Fasanella,256,299,555
553451,65129,Sant'Arsenio,1350,1457,2807
553553,65130,Sant'Egidio del Monte Albino,4366,4566,8932
553655,65131,Santomenna,217,208,425
553757,65132,San Valentino Torio,5427,5451,10878
553859,65133,Sanza,1323,1215,2538
553961,65134,Sapri,3177,3524,6701
554063,65135,Sarno,15671,15914,31585
554165,65136,Sassano,2374,2527,4901
554267,65137,Scafati,24714,25802,50516
554369,65138,Scala,775,767,1542
554471,65139,Serramezzana,133,167,300
554573,65140,Serre,1973,1944,3917
554675,65141,Sessa Cilento,601,667,1268
554777,65142,Siano,4762,5009,9771
554879,65143,Sicignano degli Alburni,1697,1657,3354
554981,65144,Stella Cilento,327,356,683
555083,65145,Stio,394,427,821
555185,65146,Teggiano,3724,4007,7731
555287,65147,Torchiara,896,944,1840
555389,65148,Torraca,615,628,1243
555491,65149,Torre Orsaia,1011,1057,2068
555593,65150,Tortorella,245,250,495
555695,65151,Tramonti,2036,2081,4117
555797,65152,Trentinara,823,814,1637
555899,65153,Valle dell'Angelo,117,112,229
556001,65154,Vallo della Lucania,3964,4388,8352
556103,65155,Valva,800,800,1600
556205,65156,Vibonati,1632,1685,3317
556307,65157,Vietri sul Mare,3768,3909,7677
556409,65158,Bellizzi,6683,6863,13546
556511,66001,Acciano,172,145,317
556613,66002,Aielli,724,755,1479
556715,66003,Alfedena,451,399,850
556817,66004,Anversa degli Abruzzi,148,162,310
556919,66005,Ateleta,565,573,1138
557021,66006,Avezzano,20517,21969,42486
557123,66007,Balsorano,1697,1735,3432
557225,66008,Barete,348,326,674
557327,66009,Barisciano,858,887,1745
557429,66010,Barrea,355,356,711
557531,66011,Bisegna,98,112,210
557633,66012,Bugnara,534,560,1094
557735,66013,Cagnano Amiterno,600,636,1236
557837,66014,Calascio,68,68,136
557939,66015,Campo di Giove,399,394,793
558041,66016,Campotosto,245,244,489
558143,66017,Canistro,478,501,979
558245,66018,Cansano,113,137,250
558347,66019,Capestrano,428,457,885
558449,66020,Capistrello,2516,2604,5120
558551,66021,Capitignano,318,333,651
558653,66022,Caporciano,104,102,206
558755,66023,Cappadocia,310,242,552
558857,66024,Carapelle Calvisio,44,41,85
558959,66025,Carsoli,2620,2674,5294
559061,66026,Castel del Monte,250,199,449
559163,66027,Castel di Ieri,149,154,303
559265,66028,Castel di Sangro,3458,3300,6758
559367,66029,Castellafiume,556,528,1084
559469,66030,Castelvecchio Calvisio,60,77,137
559571,66031,Castelvecchio Subequo,417,491,908
559673,66032,Celano,5475,5383,10858
559775,66033,Cerchio,773,791,1564
559877,66034,Civita d'Antino,525,499,1024
559979,66035,Civitella Alfedena,143,137,280
560081,66036,Civitella Roveto,1604,1553,3157
560183,66037,Cocullo,107,109,216
560285,66038,Collarmele,399,457,856
560387,66039,Collelongo,599,572,1171
560489,66040,Collepietro,114,115,229
560591,66041,Corfinio,512,513,1025
560693,66042,Fagnano Alto,195,212,407
560795,66043,Fontecchio,162,180,342
560897,66044,Fossa,352,368,720
560999,66045,Gagliano Aterno,123,129,252
561101,66046,Gioia dei Marsi,923,873,1796
561203,66047,Goriano Sicoli,273,250,523
561305,66048,Introdacqua,1019,1074,2093
561407,66049,L'Aquila,34208,35270,69478
561509,66050,Lecce nei Marsi,767,846,1613
561611,66051,Luco dei Marsi,3117,2966,6083
561713,66052,Lucoli,491,453,944
561815,66053,Magliano de' Marsi,1759,1837,3596
561917,66054,Massa d'Albe,738,710,1448
562019,66055,Molina Aterno,185,189,374
562121,66056,Montereale,1213,1183,2396
562223,66057,Morino,708,695,1403
562325,66058,Navelli,286,242,528
562427,66059,Ocre,575,572,1147
562529,66060,Ofena,218,244,462
562631,66061,Opi,207,198,405
562733,66062,Oricola,615,630,1245
562835,66063,Ortona dei Marsi,214,257,471
562937,66064,Ortucchio,887,900,1787
563039,66065,Ovindoli,620,582,1202
563141,66066,Pacentro,565,568,1133
563243,66067,Pereto,339,314,653
563345,66068,Pescasseroli,1095,1079,2174
563447,66069,Pescina,1948,2039,3987
563549,66070,Pescocostanzo,562,525,1087
563651,66071,Pettorano sul Gizio,756,689,1445
563753,66072,Pizzoli,2422,2205,4627
563855,66073,Poggio Picenze,531,573,1104
563957,66074,Prata d'Ansidonia,248,239,487
564059,66075,Pratola Peligna,3659,3810,7469
564161,66076,Prezza,474,476,950
564263,66077,Raiano,1307,1424,2731
564365,66078,Rivisondoli,379,310,689
564467,66079,Roccacasale,335,323,658
564569,66080,Rocca di Botte,440,404,844
564671,66081,Rocca di Cambio,253,233,486
564773,66082,Rocca di Mezzo,736,717,1453
564875,66083,Rocca Pia,95,81,176
564977,66084,Roccaraso,836,825,1661
565079,66085,San Benedetto dei Marsi,1935,1958,3893
565181,66086,San Benedetto in Perillis,54,51,105
565283,66087,San Demetrio ne' Vestini,949,990,1939
565385,66088,San Pio delle Camere,342,345,687
565487,66089,Sante Marie,568,579,1147
565589,66090,Sant'Eusanio Forconese,187,206,393
565691,66091,Santo Stefano di Sessanio,53,63,116
565793,66092,San Vincenzo Valle Roveto,1097,1169,2266
565895,66093,Scanno,858,909,1767
565997,66094,Scontrone,313,272,585
566099,66095,Scoppito,1913,1914,3827
566201,66096,Scurcola Marsicana,1383,1418,2801
566303,66097,Secinaro,178,166,344
566405,66098,Sulmona,11587,12274,23861
566507,66099,Tagliacozzo,3287,3404,6691
566609,66100,Tione degli Abruzzi,140,139,279
566711,66101,Tornimparte,1572,1540,3112
566813,66102,Trasacco,3133,3000,6133
566915,66103,Villalago,255,284,539
567017,66104,Villa Santa Lucia degli Abruzzi,49,48,97
567119,66105,Villa Sant'Angelo,203,231,434
567221,66106,Villavallelonga,415,466,881
567323,66107,Villetta Barrea,320,298,618
567425,66108,Vittorito,391,455,846
567527,67001,Alba Adriatica,6002,6546,12548
567629,67002,Ancarano,928,956,1884
567731,67003,Arsita,390,413,803
567833,67004,Atri,5232,5350,10582
567935,67005,Basciano,1183,1187,2370
568037,67006,Bellante,3440,3499,6939
568139,67007,Bisenti,926,922,1848
568241,67008,Campli,3543,3540,7083
568343,67009,Canzano,936,931,1867
568445,67010,Castel Castagna,239,232,471
568547,67011,Castellalto,3792,3818,7610
568649,67012,Castelli,520,558,1078
568751,67013,Castiglione Messer Raimondo,1123,1086,2209
568853,67014,Castilenti,704,677,1381
568955,67015,Cellino Attanasio,1252,1197,2449
569057,67016,Cermignano,773,801,1574
569159,67017,Civitella del Tronto,2385,2449,4834
569261,67018,Colledara,1069,1085,2154
569363,67019,Colonnella,1851,1865,3716
569465,67020,Controguerra,1167,1176,2343
569567,67021,Corropoli,2491,2593,5084
569669,67022,Cortino,323,296,619
569771,67023,Crognaleto,655,545,1200
569873,67024,Fano Adriano,146,131,277
569975,67025,Giulianova,11244,12484,23728
570077,67026,Isola del Gran Sasso d'Italia,2305,2351,4656
570179,67027,Montefino,502,485,987
570281,67028,Montorio al Vomano,3948,3991,7939
570383,67029,Morro d'Oro,1742,1840,3582
570485,67030,Mosciano Sant'Angelo,4607,4667,9274
570587,67031,Nereto,2655,2772,5427
570689,67032,Notaresco,3277,3365,6642
570791,67033,Penna Sant'Andrea,868,907,1775
570893,67034,Pietracamela,138,110,248
570995,67035,Pineto,7235,7709,14944
571097,67036,Rocca Santa Maria,264,240,504
571199,67037,Roseto degli Abruzzi,12594,13259,25853
571301,67038,Sant'Egidio alla Vibrata,4782,4942,9724
571403,67039,Sant'Omero,2598,2711,5309
571505,67040,Silvi,7740,7991,15731
571607,67041,Teramo,26298,28045,54343
571709,67042,Torano Nuovo,768,802,1570
571811,67043,Torricella Sicura,1309,1319,2628
571913,67044,Tortoreto,5795,6127,11922
572015,67045,Tossicia,630,677,1307
572117,67046,Valle Castellana,483,432,915
572219,67047,Martinsicuro,7951,8170,16121
572321,68001,Abbateggio,186,180,366
572423,68002,Alanno,1651,1812,3463
572525,68003,Bolognano,547,537,1084
572627,68004,Brittoli,143,132,275
572729,68005,Bussi sul Tirino,1179,1251,2430
572831,68006,Cappelle sul Tavo,1983,2018,4001
572933,68007,Caramanico Terme,917,938,1855
573035,68008,Carpineto della Nora,293,313,606
573137,68009,Castiglione a Casauria,392,381,773
573239,68010,Catignano,669,656,1325
573341,68011,Cepagatti,5443,5598,11041
573443,68012,Città Sant'Angelo,7481,7576,15057
573545,68013,Civitaquana,624,607,1231
573647,68014,Civitella Casanova,847,872,1719
573749,68015,Collecorvino,3006,3086,6092
573851,68016,Corvara,115,123,238
573953,68017,Cugnoli,714,726,1440
574055,68018,Elice,839,868,1707
574157,68019,Farindola,691,747,1438
574259,68020,Lettomanoppello,1425,1449,2874
574361,68021,Loreto Aprutino,3654,3721,7375
574463,68022,Manoppello,3379,3584,6963
574565,68023,Montebello di Bertona,476,465,941
574667,68024,Montesilvano,26244,28014,54258
574769,68025,Moscufo,1599,1570,3169
574871,68026,Nocciano,901,905,1806
574973,68027,Penne,5930,6178,12108
575075,68028,Pescara,55949,63348,119297
575177,68029,Pescosansonesco,233,253,486
575279,68030,Pianella,4240,4373,8613
575381,68031,Picciano,649,679,1328
575483,68032,Pietranico,226,245,471
575585,68033,Popoli,2391,2554,4945
575687,68034,Roccamorice,426,482,908
575789,68035,Rosciano,1919,2036,3955
575891,68036,Salle,146,145,291
575993,68037,Sant'Eufemia a Maiella,139,127,266
576095,68038,San Valentino in Abruzzo Citeriore,901,1003,1904
576197,68039,Scafa,1740,1864,3604
576299,68040,Serramonacesca,285,256,541
576401,68041,Spoltore,9377,9837,19214
576503,68042,Tocco da Casauria,1278,1293,2571
576605,68043,Torre de' Passeri,1455,1565,3020
576707,68044,Turrivalignani,415,437,852
576809,68045,Vicoli,184,191,375
576911,68046,Villa Celiera,309,324,633
577013,69001,Altino,1548,1616,3164
577115,69002,Archi,1011,1090,2101
577217,69003,Ari,572,570,1142
577319,69004,Arielli,535,578,1113
577421,69005,Atessa,5188,5411,10599
577523,69006,Bomba,380,388,768
577625,69007,Borrello,160,170,330
577727,69008,Bucchianico,2487,2587,5074
577829,69009,Montebello sul Sangro,34,48,82
577931,69010,Canosa Sannita,641,687,1328
578033,69011,Carpineto Sinello,279,270,549
578135,69012,Carunchio,342,294,636
578237,69013,Casacanditella,625,625,1250
578339,69014,Casalanguida,419,467,886
578441,69015,Casalbordino,2828,3153,5981
578543,69016,Casalincontrada,1502,1520,3022
578645,69017,Casoli,2719,2852,5571
578747,69018,Castel Frentano,2102,2268,4370
578849,69019,Castelguidone,174,180,354
578951,69020,Castiglione Messer Marino,798,880,1678
579053,69021,Celenza sul Trigno,445,450,895
579155,69022,Chieti,24177,26469,50646
579257,69023,Civitaluparella,166,154,320
579359,69024,Civitella Messer Raimondo,398,415,813
579461,69025,Colledimacine,103,77,180
579563,69026,Colledimezzo,240,233,473
579665,69027,Crecchio,1412,1392,2804
579767,69028,Cupello,2359,2486,4845
579869,69029,Dogliola,179,156,335
579971,69030,Fara Filiorum Petri,974,1005,1979
580073,69031,Fara San Martino,661,690,1351
580175,69032,Filetto,438,471,909
580277,69033,Fossacesia,3169,3202,6371
580379,69034,Fraine,142,163,305
580481,69035,Francavilla al Mare,12334,13543,25877
580583,69036,Fresagrandinaria,450,492,942
580685,69037,Frisa,858,861,1719
580787,69038,Furci,415,480,895
580889,69039,Gamberale,133,160,293
580991,69040,Gessopalena,642,680,1322
581093,69041,Gissi,1282,1393,2675
581195,69042,Giuliano Teatino,601,604,1205
581297,69043,Guardiagrele,4321,4560,8881
581399,69044,Guilmi,207,200,407
581501,69045,Lama dei Peligni,567,612,1179
581603,69046,Lanciano,16807,18092,34899
581705,69047,Lentella,366,334,700
581807,69048,Lettopalena,184,152,336
581909,69049,Liscia,352,340,692
582011,69050,Miglianico,2344,2395,4739
582113,69051,Montazzoli,457,460,917
582215,69052,Monteferrante,59,62,121
582317,69053,Montelapiano,39,43,82
582419,69054,Montenerodomo,331,315,646
582521,69055,Monteodorisio,1216,1234,2450
582623,69056,Mozzagrogna,1168,1277,2445
582725,69057,Orsogna,1855,1944,3799
582827,69058,Ortona,11087,11860,22947
582929,69059,Paglieta,2096,2136,4232
583031,69060,Palena,651,656,1307
583133,69061,Palmoli,460,445,905
583235,69062,Palombaro,482,509,991
583337,69063,Pennadomo,111,121,232
583439,69064,Pennapiedimonte,222,223,445
583541,69065,Perano,773,803,1576
583643,69066,Pizzoferrato,528,496,1024
583745,69067,Poggiofiorito,406,444,850
583847,69068,Pollutri,1046,1124,2170
583949,69069,Pretoro,431,470,901
584051,69070,Quadri,366,395,761
584153,69071,Rapino,617,638,1255
584255,69072,Ripa Teatina,2045,1996,4041
584357,69073,Roccamontepiano,841,828,1669
584459,69074,Rocca San Giovanni,1172,1146,2318
584561,69075,Roccascalegna,572,590,1162
584663,69076,Roccaspinalveti,613,647,1260
584765,69077,Roio del Sangro,47,47,94
584867,69078,Rosello,102,122,224
584969,69079,San Buono,498,438,936
585071,69080,San Giovanni Lipioni,73,78,151
585173,69081,San Giovanni Teatino,7050,7362,14412
585275,69082,San Martino sulla Marrucina,462,450,912
585377,69083,San Salvo,10073,10098,20171
585479,69084,Santa Maria Imbaro,1043,997,2040
585581,69085,Sant'Eusanio del Sangro,1205,1235,2440
585683,69086,San Vito Chietino,2598,2693,5291
585785,69087,Scerni,1549,1642,3191
585887,69088,Schiavi di Abruzzo,360,417,777
585989,69089,Taranta Peligna,174,179,353
586091,69090,Tollo,2018,2072,4090
586193,69091,Torino di Sangro,1512,1508,3020
586295,69092,Tornareccio,867,886,1753
586397,69093,Torrebruna,371,413,784
586499,69094,Torrevecchia Teatina,2098,2123,4221
586601,69095,Torricella Peligna,595,687,1282
586703,69096,Treglio,810,849,1659
586805,69097,Tufillo,181,197,378
586907,69098,Vacri,803,833,1636
587009,69099,Vasto,20271,21218,41489
587111,69100,Villalfonsina,456,472,928
587213,69101,Villamagna,1146,1142,2288
587315,69102,Villa Santa Maria,667,644,1311
587417,69103,Pietraferrazzana,60,69,129
587519,69104,Fallo,72,65,137
587621,70001,Acquaviva Collecroce,317,308,625
587723,70002,Baranello,1271,1345,2616
587825,70003,Bojano,3963,4070,8033
587927,70004,Bonefro,637,679,1316
588029,70005,Busso,585,611,1196
588131,70006,Campobasso,23518,25531,49049
588233,70007,Campochiaro,298,327,625
588335,70008,Campodipietra,1204,1268,2472
588437,70009,Campolieto,445,410,855
588539,70010,Campomarino,4072,3809,7881
588641,70011,Casacalenda,1000,1018,2018
588743,70012,Casalciprano,247,270,517
588845,70013,Castelbottaccio,126,143,269
588947,70014,Castellino del Biferno,287,268,555
589049,70015,Castelmauro,699,732,1431
589151,70016,Castropignano,439,479,918
589253,70017,Cercemaggiore,1876,1810,3686
589355,70018,Cercepiccola,294,348,642
589457,70019,Civitacampomarano,166,201,367
589559,70020,Colle d'Anchise,384,400,784
589661,70021,Colletorto,880,951,1831
589763,70022,Duronia,204,200,404
589865,70023,Ferrazzano,1634,1648,3282
589967,70024,Fossalto,606,658,1264
590069,70025,Gambatesa,673,732,1405
590171,70026,Gildone,386,399,785
590273,70027,Guardialfiera,497,526,1023
590375,70028,Guardiaregia,381,387,768
590477,70029,Guglionesi,2622,2580,5202
590579,70030,Jelsi,940,855,1795
590681,70031,Larino,3297,3377,6674
590783,70032,Limosano,379,339,718
590885,70033,Lucito,313,341,654
590987,70034,Lupara,226,240,466
591089,70035,Macchia Valfortore,272,268,540
591191,70036,Mafalda,577,590,1167
591293,70037,Matrice,536,554,1090
591395,70038,Mirabello Sannitico,1073,1063,2136
591497,70039,Molise,96,75,171
591599,70040,Monacilioni,222,261,483
591701,70041,Montagano,507,542,1049
591803,70042,Montecilfone,658,656,1314
591905,70043,Montefalcone nel Sannio,738,748,1486
592007,70044,Montelongo,170,176,346
592109,70045,Montemitro,167,169,336
592211,70046,Montenero di Bisaccia,3238,3252,6490
592313,70047,Montorio nei Frentani,202,194,396
592415,70048,Morrone del Sannio,297,279,576
592517,70049,Oratino,876,818,1694
592619,70050,Palata,821,847,1668
592721,70051,Petacciato,1966,1820,3786
592823,70052,Petrella Tifernina,539,579,1118
592925,70053,Pietracatella,620,670,1290
593027,70054,Pietracupa,105,110,215
593129,70055,Portocannone,1231,1227,2458
593231,70056,Provvidenti,61,48,109
593333,70057,Riccia,2486,2598,5084
593435,70058,Ripabottoni,244,249,493
593537,70059,Ripalimosani,1569,1515,3084
593639,70060,Roccavivara,378,363,741
593741,70061,Rotello,612,587,1199
593843,70062,Salcito,342,304,646
593945,70063,San Biase,81,84,165
594047,70064,San Felice del Molise,301,302,603
594149,70065,San Giacomo degli Schiavoni,681,729,1410
594251,70066,San Giovanni in Galdo,264,289,553
594353,70067,San Giuliano del Sannio,496,489,985
594455,70068,San Giuliano di Puglia,495,546,1041
594557,70069,San Martino in Pensilis,2297,2413,4710
594659,70070,San Massimo,446,388,834
594761,70071,San Polo Matese,248,236,484
594863,70072,Santa Croce di Magliano,2049,2229,4278
594965,70073,Sant'Angelo Limosano,167,178,345
595067,70074,Sant'Elia a Pianisi,822,875,1697
595169,70075,Sepino,968,877,1845
595271,70076,Spinete,623,612,1235
595373,70077,Tavenna,312,361,673
595475,70078,Termoli,16441,17176,33617
595577,70079,Torella del Sannio,372,365,737
595679,70080,Toro,626,683,1309
595781,70081,Trivento,2303,2340,4643
595883,70082,Tufara,414,443,857
595985,70083,Ururi,1233,1382,2615
596087,70084,Vinchiaturo,1642,1669,3311
596189,71001,Accadia,1120,1187,2307
596291,71002,Alberona,449,476,925
596393,71003,Anzano di Puglia,576,641,1217
596495,71004,Apricena,6457,6653,13110
596597,71005,Ascoli Satriano,3091,3050,6141
596699,71006,Biccari,1344,1376,2720
596801,71007,Bovino,1564,1642,3206
596903,71008,Cagnano Varano,3521,3586,7107
597005,71009,Candela,1397,1360,2757
597107,71010,Carapelle,3299,3316,6615
597209,71011,Carlantino,476,481,957
597311,71012,Carpino,2024,2060,4084
597413,71013,Casalnuovo Monterotaro,712,750,1462
597515,71014,Casalvecchio di Puglia,898,907,1805
597617,71015,Castelluccio dei Sauri,1060,1072,2132
597719,71016,Castelluccio Valmaggiore,608,639,1247
597821,71017,Castelnuovo della Daunia,656,709,1365
597923,71018,Celenza Valfortore,725,783,1508
598025,71019,Celle di San Vito,83,76,159
598127,71020,Cerignola,28997,29638,58635
598229,71021,Chieuti,823,833,1656
598331,71022,Deliceto,1831,1889,3720
598433,71023,Faeto,299,322,621
598535,71024,Foggia,73520,77683,151203
598637,71025,Ischitella,2182,2202,4384
598739,71026,Isole Tremiti,274,201,475
598841,71027,Lesina,3142,3172,6314
598943,71028,Lucera,16021,16868,32889
599045,71029,Manfredonia,28196,28542,56738
599147,71031,Mattinata,3061,3154,6215
599249,71032,Monteleone di Puglia,512,492,1004
599351,71033,Monte Sant'Angelo,5919,6243,12162
599453,71034,Motta Montecorvino,325,370,695
599555,71035,Orsara di Puglia,1312,1340,2652
599657,71036,Orta Nova,8730,8854,17584
599759,71037,Panni,358,391,749
599861,71038,Peschici,2255,2233,4488
599963,71039,Pietramontecorvino,1274,1367,2641
600065,71040,Poggio Imperiale,1303,1337,2640
600167,71041,Rignano Garganico,950,1044,1994
600269,71042,Rocchetta Sant'Antonio,887,927,1814
600371,71043,Rodi Garganico,1791,1828,3619
600473,71044,Roseto Valfortore,510,556,1066
600575,71046,San Giovanni Rotondo,13238,13870,27108
600677,71047,San Marco in Lamis,6536,6861,13397
600779,71048,San Marco la Catola,483,480,963
600881,71049,San Nicandro Garganico,7257,7806,15063
600983,71050,San Paolo di Civitate,2787,2924,5711
601085,71051,San Severo,25476,26950,52426
601187,71052,Sant'Agata di Puglia,928,968,1896
601289,71053,Serracapriola,1870,2007,3877
601391,71054,Stornara,2897,2880,5777
601493,71055,Stornarella,2594,2712,5306
601595,71056,Torremaggiore,8375,8603,16978
601697,71058,Troia,3409,3626,7035
601799,71059,Vico del Gargano,3711,3928,7639
601901,71060,Vieste,6927,6980,13907
602003,71061,Volturara Appula,182,226,408
602105,71062,Volturino,803,881,1684
602207,71063,Ordona,1432,1408,2840
602309,71064,Zapponeta,1733,1653,3386
602411,72001,Acquaviva delle Fonti,9936,10587,20523
602513,72002,Adelfia,8244,8578,16822
602615,72003,Alberobello,5154,5500,10654
602717,72004,Altamura,34663,36004,70667
602819,72006,Bari,154136,166726,320862
602921,72008,Binetto,1127,1099,2226
603023,72010,Bitetto,5912,6063,11975
603125,72011,Bitonto,26844,27782,54626
603227,72012,Bitritto,5557,5721,11278
603329,72014,Capurso,7626,7972,15598
603431,72015,Casamassima,9755,10054,19809
603533,72016,Cassano delle Murge,7280,7480,14760
603635,72017,Castellana Grotte,9458,10112,19570
603737,72018,Cellamare,2860,2966,5826
603839,72019,Conversano,12842,13333,26175
603941,72020,Corato,23468,24765,48233
604043,72021,Gioia del Colle,13551,14022,27573
604145,72022,Giovinazzo,9832,10441,20273
604247,72023,Gravina in Puglia,21752,22064,43816
604349,72024,Grumo Appula,6370,6268,12638
604451,72025,Locorotondo,6895,7291,14186
604553,72027,Modugno,18738,19465,38203
604655,72028,Mola di Bari,12525,12786,25311
604757,72029,Molfetta,28767,30524,59291
604859,72030,Monopoli,23811,25011,48822
604961,72031,Noci,9249,9796,19045
605063,72032,Noicattaro,13063,13259,26322
605165,72033,Palo del Colle,10521,10777,21298
605267,72034,Poggiorsini,799,673,1472
605369,72035,Polignano a Mare,8758,9167,17925
605471,72036,Putignano,13008,13592,26600
605573,72037,Rutigliano,9176,9356,18532
605675,72038,Ruvo di Puglia,12359,12921,25280
605777,72039,Sammichele di Bari,3070,3266,6336
605879,72040,Sannicandro di Bari,5064,4819,9883
605981,72041,Santeramo in Colle,13066,13373,26439
606083,72043,Terlizzi,13370,13513,26883
606185,72044,Toritto,4043,4183,8226
606287,72046,Triggiano,13211,13964,27175
606389,72047,Turi,6335,6703,13038
606491,72048,Valenzano,8661,9162,17823
606593,73001,Avetrana,3138,3409,6547
606695,73002,Carosino,3389,3535,6924
606797,73003,Castellaneta,8300,8608,16908
606899,73004,Crispiano,6689,6931,13620
607001,73005,Faggiano,1697,1779,3476
607103,73006,Fragagnano,2497,2676,5173
607205,73007,Ginosa,11105,11210,22315
607307,73008,Grottaglie,15389,16467,31856
607409,73009,Laterza,7446,7698,15144
607511,73010,Leporano,4080,4063,8143
607613,73011,Lizzano,4837,5030,9867
607715,73012,Manduria,15036,15951,30987
607817,73013,Martina Franca,23327,25183,48510
607919,73014,Maruggio,2587,2648,5235
608021,73015,Massafra,16093,16679,32772
608123,73016,Monteiasi,2695,2852,5547
608225,73017,Montemesola,1840,1923,3763
608327,73018,Monteparano,1156,1211,2367
608429,73019,Mottola,7774,8069,15843
608531,73020,Palagianello,3792,4020,7812
608633,73021,Palagiano,7986,8052,16038
608735,73022,Pulsano,5658,5771,11429
608837,73023,Roccaforzata,887,921,1808
608939,73024,San Giorgio Ionico,7257,7732,14989
609041,73025,San Marzano di San Giuseppe,4545,4598,9143
609143,73026,Sava,7717,8207,15924
609245,73027,Taranto,93904,102798,196702
609347,73028,Torricella,2062,2121,4183
609449,73029,Statte,6773,6958,13731
609551,74001,Brindisi,41698,45114,86812
609653,74002,Carovigno,8599,8477,17076
609755,74003,Ceglie Messapica,9361,10277,19638
609857,74004,Cellino San Marco,3057,3371,6428
609959,74005,Cisternino,5583,5945,11528
610061,74006,Erchie,4183,4424,8607
610163,74007,Fasano,19376,20450,39826
610265,74008,Francavilla Fontana,17464,18679,36143
610367,74009,Latiano,6947,7323,14270
610469,74010,Mesagne,12688,13919,26607
610571,74011,Oria,7262,7773,15035
610673,74012,Ostuni,14802,16101,30903
610775,74013,San Donaci,3121,3358,6479
610877,74014,San Michele Salentino,3085,3177,6262
610979,74015,San Pancrazio Salentino,4760,5044,9804
611081,74016,San Pietro Vernotico,6348,7063,13411
611183,74017,San Vito dei Normanni,9263,9824,19087
611285,74018,Torchiarolo,2636,2734,5370
611387,74019,Torre Santa Susanna,5043,5396,10439
611489,74020,Villa Castelli,4602,4648,9250
611591,75001,Acquarica del Capo,2227,2410,4637
611693,75002,Alessano,3079,3321,6400
611795,75003,Alezio,2694,2935,5629
611897,75004,Alliste,3193,3500,6693
611999,75005,Andrano,2329,2462,4791
612101,75006,Aradeo,4441,4817,9258
612203,75007,Arnesano,2011,2042,4053
612305,75008,Bagnolo del Salento,884,934,1818
612407,75009,Botrugno,1284,1435,2719
612509,75010,Calimera,3238,3690,6928
612611,75011,Campi Salentina,4900,5387,10287
612713,75012,Cannole,830,845,1675
612815,75013,Caprarica di Lecce,1139,1272,2411
612917,75014,Carmiano,5843,6191,12034
613019,75015,Carpignano Salentino,1842,1891,3733
613121,75016,Casarano,9510,10466,19976
613223,75017,Castri di Lecce,1407,1457,2864
613325,75018,Castrignano de' Greci,1881,2014,3895
613427,75019,Castrignano del Capo,2484,2673,5157
613529,75020,Cavallino,6155,6674,12829
613631,75021,Collepasso,2836,3049,5885
613733,75022,Copertino,11594,12315,23909
613835,75023,Corigliano d'Otranto,2716,3041,5757
613937,75024,Corsano,2676,2708,5384
614039,75025,Cursi,2013,2087,4100
614141,75026,Cutrofiano,4269,4677,8946
614243,75027,Diso,1397,1548,2945
614345,75028,Gagliano del Capo,2483,2621,5104
614447,75029,Galatina,12754,13994,26748
614549,75030,Galatone,7414,8005,15419
614651,75031,Gallipoli,9874,10531,20405
614753,75032,Giuggianello,575,601,1176
614855,75033,Giurdignano,958,988,1946
614957,75034,Guagnano,2693,2942,5635
615059,75035,Lecce,45020,50249,95269
615161,75036,Lequile,4185,4458,8643
615263,75037,Leverano,6835,7182,14017
615365,75038,Lizzanello,5853,6081,11934
615467,75039,Maglie,6623,7543,14166
615569,75040,Martano,4286,4719,9005
615671,75041,Martignano,814,830,1644
615773,75042,Matino,5522,5885,11407
615875,75043,Melendugno,4911,5097,10008
615977,75044,Melissano,3393,3671,7064
616079,75045,Melpignano,1072,1139,2211
616181,75046,Miggiano,1639,1837,3476
616283,75047,Minervino di Lecce,1680,1911,3591
616385,75048,Monteroni di Lecce,6756,7138,13894
616487,75049,Montesano Salentino,1306,1357,2663
616589,75050,Morciano di Leuca,1490,1740,3230
616691,75051,Muro Leccese,2366,2555,4921
616793,75052,Nardò,14971,16373,31344
616895,75053,Neviano,2464,2737,5201
616997,75054,Nociglia,1057,1198,2255
617099,75055,Novoli,3785,4181,7966
617201,75056,Ortelle,1187,1182,2369
617303,75057,Otranto,2853,3045,5898
617405,75058,Palmariggi,719,737,1456
617507,75059,Parabita,4248,4668,8916
617609,75060,Patù,813,891,1704
617711,75061,Poggiardo,2789,3130,5919
617813,75062,Presicce,2459,2763,5222
617915,75063,Racale,5343,5634,10977
618017,75064,Ruffano,4657,5041,9698
618119,75065,Salice Salentino,3901,4249,8150
618221,75066,Salve,2163,2409,4572
618323,75067,Sanarica,709,769,1478
618425,75068,San Cesario di Lecce,3887,4237,8124
618527,75069,San Donato di Lecce,2646,3007,5653
618629,75070,Sannicola,2797,3039,5836
618731,75071,San Pietro in Lama,1649,1840,3489
618833,75072,Santa Cesarea Terme,1447,1580,3027
618935,75073,Scorrano,3385,3545,6930
619037,75074,Seclì,893,980,1873
619139,75075,Sogliano Cavour,1973,2058,4031
619241,75076,Soleto,2539,2817,5356
619343,75077,Specchia,2292,2460,4752
619445,75078,Spongano,1734,1918,3652
619547,75079,Squinzano,6746,7272,14018
619649,75080,Sternatia,1042,1200,2242
619751,75081,Supersano,2143,2199,4342
619853,75082,Surano,756,859,1615
619955,75083,Surbo,7389,7709,15098
620057,75084,Taurisano,5631,6095,11726
620159,75085,Taviano,5684,6222,11906
620261,75086,Tiggiano,1434,1438,2872
620363,75087,Trepuzzi,6882,7487,14369
620465,75088,Tricase,8421,9000,17421
620567,75089,Tuglie,2475,2732,5207
620669,75090,Ugento,5951,6395,12346
620771,75091,Uggiano la Chiesa,2066,2315,4381
620873,75092,Veglie,6658,7172,13830
620975,75093,Vernole,3391,3645,7036
621077,75094,Zollino,918,1006,1924
621179,75095,San Cassiano,996,1012,2008
621281,75096,Castro,1110,1258,2368
621383,75097,Porto Cesareo,3144,3144,6288
621485,76001,Abriola,683,746,1429
621587,76002,Acerenza,1153,1165,2318
621689,76003,Albano di Lucania,721,680,1401
621791,76004,Anzi,775,844,1619
621893,76005,Armento,284,309,593
621995,76006,Atella,1917,1958,3875
622097,76007,Avigliano,5450,5771,11221
622199,76008,Balvano,936,873,1809
622301,76009,Banzi,659,646,1305
622403,76010,Baragiano,1276,1334,2610
622505,76011,Barile,1322,1403,2725
622607,76012,Bella,2491,2504,4995
622709,76013,Brienza,2015,1988,4003
622811,76014,Brindisi Montagna,444,415,859
622913,76015,Calvello,910,990,1900
623015,76016,Calvera,184,191,375
623117,76017,Campomaggiore,388,385,773
623219,76018,Cancellara,628,628,1256
623321,76019,Carbone,288,299,587
623423,76020,San Paolo Albanese,110,138,248
623525,76021,Castelgrande,447,448,895
623627,76022,Castelluccio Inferiore,994,1034,2028
623729,76023,Castelluccio Superiore,379,393,772
623831,76024,Castelmezzano,367,404,771
623933,76025,Castelsaraceno,626,681,1307
624035,76026,Castronuovo di Sant'Andrea,471,528,999
624137,76027,Cersosimo,300,308,608
624239,76028,Chiaromonte,923,959,1882
624341,76029,Corleto Perticara,1255,1247,2502
624443,76030,Episcopia,680,695,1375
624545,76031,Fardella,295,301,596
624647,76032,Filiano,1412,1457,2869
624749,76033,Forenza,1015,970,1985
624851,76034,Francavilla in Sinni,2054,2098,4152
624953,76035,Gallicchio,455,419,874
625055,76036,Genzano di Lucania,2772,2862,5634
625157,76037,Grumento Nova,815,848,1663
625259,76038,Guardia Perticara,253,287,540
625361,76039,Lagonegro,2586,2787,5373
625463,76040,Latronico,2129,2213,4342
625565,76041,Laurenzana,846,868,1714
625667,76042,Lauria,6099,6459,12558
625769,76043,Lavello,6757,6663,13420
625871,76044,Maratea,2456,2589,5045
625973,76045,Marsico Nuovo,1893,2077,3970
626075,76046,Marsicovetere,2771,2790,5561
626177,76047,Maschito,799,824,1623
626279,76048,Melfi,8772,8967,17739
626381,76049,Missanello,287,278,565
626483,76050,Moliterno,1821,2021,3842
626585,76051,Montemilone,764,772,1536
626687,76052,Montemurro,577,604,1181
626789,76053,Muro Lucano,2614,2690,5304
626891,76054,Nemoli,702,751,1453
626993,76055,Noepoli,376,437,813
627095,76056,Oppido Lucano,1882,1878,3760
627197,76057,Palazzo San Gervasio,2387,2379,4766
627299,76058,Pescopagano,888,931,1819
627401,76059,Picerno,2932,2920,5852
627503,76060,Pietragalla,1969,2056,4025
627605,76061,Pietrapertosa,473,504,977
627707,76062,Pignola,3467,3486,6953
627809,76063,Potenza,32155,34614,66769
627911,76064,Rapolla,2190,2145,4335
628013,76065,Rapone,442,486,928
628115,76066,Rionero in Vulture,6472,6629,13101
628217,76067,Ripacandida,845,839,1684
628319,76068,Rivello,1305,1400,2705
628421,76069,Roccanova,704,750,1454
628523,76070,Rotonda,1704,1692,3396
628625,76071,Ruoti,1744,1781,3525
628727,76072,Ruvo del Monte,511,540,1051
628829,76073,San Chirico Nuovo,634,660,1294
628931,76074,San Chirico Raparo,493,508,1001
629033,76075,San Costantino Albanese,329,335,664
629135,76076,San Fele,1382,1477,2859
629237,76077,San Martino d'Agri,372,362,734
629339,76078,San Severino Lucano,734,767,1501
629441,76079,Sant'Angelo Le Fratte,690,704,1394
629543,76080,Sant'Arcangelo,3106,3179,6285
629645,76081,Sarconi,710,708,1418
629747,76082,Sasso di Castalda,435,396,831
629849,76083,Satriano di Lucania,1168,1149,2317
629951,76084,Savoia di Lucania,546,534,1080
630053,76085,Senise,3429,3485,6914
630155,76086,Spinoso,678,730,1408
630257,76087,Teana,257,312,569
630359,76088,Terranova di Pollino,546,585,1131
630461,76089,Tito,3648,3684,7332
630563,76090,Tolve,1589,1571,3160
630665,76091,Tramutola,1473,1541,3014
630767,76092,Trecchina,1083,1173,2256
630869,76093,Trivigno,307,332,639
630971,76094,Vaglio Basilicata,938,1023,1961
631073,76095,Venosa,5786,5841,11627
631175,76096,Vietri di Potenza,1405,1391,2796
631277,76097,Viggianello,1437,1451,2888
631379,76098,Viggiano,1711,1656,3367
631481,76099,Ginestra,381,359,740
631583,76100,Paterno,1595,1693,3288
631685,77001,Accettura,858,899,1757
631787,77002,Aliano,471,483,954
631889,77003,Bernalda,6268,6155,12423
631991,77004,Calciano,371,341,712
632093,77005,Cirigliano,149,202,351
632195,77006,Colobraro,582,605,1187
632297,77007,Craco,344,363,707
632399,77008,Ferrandina,4171,4285,8456
632501,77009,Garaguso,515,512,1027
632603,77010,Gorgoglione,480,467,947
632705,77011,Grassano,2532,2512,5044
632807,77012,Grottole,1021,1088,2109
632909,77013,Irsina,2334,2403,4737
633011,77014,Matera,29513,30891,60404
633113,77015,Miglionico,1246,1229,2475
633215,77016,Montalbano Jonico,3494,3658,7152
633317,77017,Montescaglioso,4840,4936,9776
633419,77018,Nova Siri,3406,3409,6815
633521,77019,Oliveto Lucano,188,211,399
633623,77020,Pisticci,8602,8936,17538
633725,77021,Policoro,8731,9144,17875
633827,77022,Pomarico,1996,2042,4038
633929,77023,Rotondella,1240,1310,2550
634031,77024,Salandra,1338,1358,2696
634133,77025,San Giorgio Lucano,572,556,1128
634235,77026,San Mauro Forte,710,735,1445
634337,77027,Stigliano,1883,2123,4006
634439,77028,Tricarico,2509,2615,5124
634541,77029,Tursi,2488,2468,4956
634643,77030,Valsinni,697,755,1452
634745,77031,Scanzano Jonico,3820,3849,7669
634847,78001,Acquaformosa,542,553,1095
634949,78002,Acquappesa,910,928,1838
635051,78003,Acri,9793,10432,20225
635153,78004,Aiello Calabro,791,843,1634
635255,78005,Aieta,404,405,809
635357,78006,Albidona,616,652,1268
635459,78007,Alessandria del Carretto,222,193,415
635561,78008,Altilia,371,325,696
635663,78009,Altomonte,2155,2220,4375
635765,78010,Amantea,6869,7213,14082
635867,78011,Amendolara,1457,1426,2883
635969,78012,Aprigliano,1414,1453,2867
636071,78013,Belmonte Calabro,931,1001,1932
636173,78014,Belsito,456,463,919
636275,78015,Belvedere Marittimo,4393,4873,9266
636377,78016,Bianchi,644,621,1265
636479,78017,Bisignano,4975,5076,10051
636581,78018,Bocchigliero,559,654,1213
636683,78019,Bonifati,1333,1433,2766
636785,78020,Buonvicino,1048,1138,2186
636887,78021,Calopezzati,666,709,1375
636989,78022,Caloveto,596,595,1191
637091,78023,Campana,814,863,1677
637193,78024,Canna,333,372,705
637295,78025,Cariati,3940,4154,8094
637397,78026,Carolei,1679,1656,3335
637499,78027,Carpanzano,108,126,234
637601,78029,Cassano all'Ionio,9035,9051,18086
637703,78030,Castiglione Cosentino,1566,1413,2979
637805,78031,Castrolibero,4720,5002,9722
637907,78032,Castroregio,140,128,268
638009,78033,Castrovillari,10507,11363,21870
638111,78034,Celico,1416,1372,2788
638213,78035,Cellara,245,252,497
638315,78036,Cerchiara di Calabria,1167,1157,2324
638417,78037,Cerisano,1505,1553,3058
638519,78038,Cervicati,404,407,811
638621,78039,Cerzeto,681,640,1321
638723,78040,Cetraro,4990,5016,10006
638825,78041,Civita,448,440,888
638927,78042,Cleto,658,593,1251
639029,78043,Colosimi,592,634,1226
639131,78045,Cosenza,31613,35657,67270
639233,78046,Cropalati,539,526,1065
639335,78047,Crosia,4899,5049,9948
639437,78048,Diamante,2526,2723,5249
639539,78049,Dipignano,2108,2217,4325
639641,78050,Domanico,452,489,941
639743,78051,Fagnano Castello,1838,1950,3788
639845,78052,Falconara Albanese,716,735,1451
639947,78053,Figline Vegliaturo,561,599,1160
640049,78054,Firmo,994,1018,2012
640151,78055,Fiumefreddo Bruzio,1446,1472,2918
640253,78056,Francavilla Marittima,1392,1483,2875
640355,78057,Frascineto,974,1065,2039
640457,78058,Fuscaldo,4082,4078,8160
640559,78059,Grimaldi,831,812,1643
640661,78060,Grisolia,1099,1130,2229
640763,78061,Guardia Piemontese,932,994,1926
640865,78062,Lago,1233,1273,2506
640967,78063,Laino Borgo,903,957,1860
641069,78064,Laino Castello,371,440,811
641171,78065,Lappano,452,464,916
641273,78066,Lattarico,1948,1969,3917
641375,78067,Longobardi,1238,1117,2355
641477,78068,Longobucco,1467,1478,2945
641579,78069,Lungro,1236,1225,2461
641681,78070,Luzzi,4503,4648,9151
641783,78071,Maierà,610,609,1219
641885,78072,Malito,384,390,774
641987,78073,Malvito,885,862,1747
642089,78074,Mandatoriccio,1368,1373,2741
642191,78075,Mangone,943,919,1862
642293,78076,Marano Marchesato,1696,1777,3473
642395,78077,Marano Principato,1563,1586,3149
642497,78078,Marzi,499,492,991
642599,78079,Mendicino,4754,4741,9495
642701,78080,Mongrassano,777,772,1549
642803,78081,Montalto Uffugo,10037,10454,20491
642905,78082,Montegiordano,855,913,1768
643007,78083,Morano Calabro,2152,2191,4343
643109,78084,Mormanno,1393,1490,2883
643211,78085,Mottafollone,579,618,1197
643313,78086,Nocara,171,192,363
643415,78087,Oriolo,989,1078,2067
643517,78088,Orsomarso,612,614,1226
643619,78089,Paludi,528,507,1035
643721,78090,Panettieri,160,167,327
643823,78091,Paola,7551,8137,15688
643925,78092,Papasidero,338,333,671
644027,78093,Parenti,1062,1062,2124
644129,78094,Paterno Calabro,720,688,1408
644231,78096,Pedivigliano,389,426,815
644333,78097,Piane Crati,691,724,1415
644435,78098,Pietrafitta,612,634,1246
644537,78099,Pietrapaola,510,571,1081
644639,78100,Plataci,366,348,714
644741,78101,Praia a Mare,3149,3508,6657
644843,78102,Rende,17357,18169,35526
644945,78103,Rocca Imperiale,1643,1687,3330
645047,78104,Roggiano Gravina,3509,3687,7196
645149,78105,Rogliano,2922,2791,5713
645251,78106,Rose,2187,2208,4395
645353,78107,Roseto Capo Spulico,950,955,1905
645455,78109,Rota Greca,558,537,1095
645557,78110,Rovito,1585,1570,3155
645659,78111,San Basile,471,532,1003
645761,78112,San Benedetto Ullano,754,750,1504
645863,78113,San Cosmo Albanese,274,322,596
645965,78114,San Demetrio Corone,1616,1741,3357
646067,78115,San Donato di Ninea,603,645,1248
646169,78116,San Fili,1321,1313,2634
646271,78117,Sangineto,645,639,1284
646373,78118,San Giorgio Albanese,677,710,1387
646475,78119,San Giovanni in Fiore,8190,8662,16852
646577,78120,San Lorenzo Bellizzi,289,299,588
646679,78121,San Lorenzo del Vallo,1662,1644,3306
646781,78122,San Lucido,3024,3105,6129
646883,78123,San Marco Argentano,3681,3719,7400
646985,78124,San Martino di Finita,502,522,1024
647087,78125,San Nicola Arcella,1003,996,1999
647189,78126,San Pietro in Amantea,240,258,498
647291,78127,San Pietro in Guarano,1790,1839,3629
647393,78128,San Sosti,1089,1059,2148
647495,78129,Santa Caterina Albanese,580,618,1198
647597,78130,Santa Domenica Talao,607,604,1211
647699,78131,Sant'Agata di Esaro,907,900,1807
647801,78132,Santa Maria del Cedro,2455,2549,5004
647903,78133,Santa Sofia d'Epiro,1186,1284,2470
648005,78134,Santo Stefano di Rogliano,841,872,1713
648107,78135,San Vincenzo La Costa,1072,1087,2159
648209,78136,Saracena,1834,1873,3707
648311,78137,Scala Coeli,428,498,926
648413,78138,Scalea,5590,5501,11091
648515,78139,Scigliano,596,615,1211
648617,78140,Serra d'Aiello,234,242,476
648719,78142,Spezzano Albanese,3454,3491,6945
648821,78143,Spezzano della Sila,2293,2204,4497
648923,78145,Tarsia,1013,985,1998
649025,78146,Terranova da Sibari,2475,2473,4948
649127,78147,Terravecchia,346,372,718
649229,78148,Torano Castello,2308,2293,4601
649331,78149,Tortora,2974,3157,6131
649433,78150,Trebisacce,4375,4641,9016
649535,78152,Vaccarizzo Albanese,527,570,1097
649637,78153,Verbicaro,1416,1466,2882
649739,78154,Villapiana,2687,2754,5441
649841,78155,Zumpano,1290,1328,2618
649943,78156,Casali del Manco,4887,5041,9928
650045,78157,Corigliano-Rossano,37995,39133,77128
650147,79002,Albi,446,441,887
650249,79003,Amaroni,876,917,1793
650351,79004,Amato,394,422,816
650453,79005,Andali,339,352,691
650555,79007,Argusto,245,250,495
650657,79008,Badolato,1415,1524,2939
650759,79009,Belcastro,662,640,1302
650861,79011,Borgia,3714,3850,7564
650963,79012,Botricello,2535,2700,5235
651065,79017,Caraffa di Catanzaro,894,906,1800
651167,79018,Cardinale,974,1053,2027
651269,79020,Carlopoli,744,753,1497
651371,79023,Catanzaro,42480,46585,89065
651473,79024,Cenadi,265,265,530
651575,79025,Centrache,184,201,385
651677,79027,Cerva,567,613,1180
651779,79029,Chiaravalle Centrale,2623,2889,5512
651881,79030,Cicala,449,478,927
651983,79033,Conflenti,689,682,1371
652085,79034,Cortale,990,1058,2048
652187,79036,Cropani,2370,2464,4834
652289,79039,Curinga,3275,3411,6686
652391,79042,Davoli,2710,2810,5520
652493,79043,Decollatura,1558,1579,3137
652595,79047,Falerna,1985,1953,3938
652697,79048,Feroleto Antico,1001,1049,2050
652799,79052,Fossato Serralta,298,293,591
652901,79055,Gagliato,217,240,457
653003,79056,Gasperina,1063,1066,2129
653105,79058,Gimigliano,1587,1630,3217
653207,79059,Girifalco,2817,2972,5789
653309,79060,Gizzeria,2757,2491,5248
653411,79061,Guardavalle,2202,2303,4505
653513,79063,Isca sullo Ionio,777,804,1581
653615,79065,Jacurso,279,326,605
653717,79068,Magisano,584,600,1184
653819,79069,Maida,2299,2342,4641
653921,79071,Marcedusa,211,208,419
654023,79072,Marcellinara,1075,1168,2243
654125,79073,Martirano,429,446,875
654227,79074,Martirano Lombardo,518,526,1044
654329,79077,Miglierina,339,400,739
654431,79080,Montauro,847,909,1756
654533,79081,Montepaone,2769,2771,5540
654635,79083,Motta Santa Lucia,411,399,810
654737,79087,Nocera Terinese,2394,2406,4800
654839,79088,Olivadi,254,270,524
654941,79089,Palermiti,555,619,1174
655043,79092,Pentone,969,1045,2014
655145,79094,Petrizzi,548,555,1103
655247,79095,Petronà,1266,1344,2610
655349,79096,Pianopoli,1293,1316,2609
655451,79099,Platania,1002,1079,2081
655553,79108,San Floro,357,377,734
655655,79110,San Mango d'Aquino,744,776,1520
655757,79114,San Pietro a Maida,2011,2056,4067
655859,79115,San Pietro Apostolo,829,846,1675
655961,79116,San Sostene,700,690,1390
656063,79117,Santa Caterina dello Ionio,1066,1050,2116
656165,79118,Sant'Andrea Apostolo dello Ionio,905,917,1822
656267,79122,San Vito sullo Ionio,820,903,1723
656369,79123,Satriano,1675,1768,3443
656471,79126,Sellia,244,285,529
656573,79127,Sellia Marina,3888,3803,7691
656675,79129,Serrastretta,1526,1574,3100
656777,79130,Sersale,2198,2305,4503
656879,79131,Settingiano,1588,1536,3124
656981,79133,Simeri Crichi,2336,2382,4718
657083,79134,Sorbo San Basile,394,403,797
657185,79137,Soverato,4216,4814,9030
657287,79138,Soveria Mannelli,1439,1556,2995
657389,79139,Soveria Simeri,758,776,1534
657491,79142,Squillace,1813,1839,3652
657593,79143,Stalettì,1197,1188,2385
657695,79146,Taverna,1309,1290,2599
657797,79147,Tiriolo,1872,1943,3815
657899,79148,Torre di Ruggiero,461,519,980
658001,79151,Vallefiorita,786,891,1677
658103,79157,Zagarise,770,812,1582
658205,79160,Lamezia Terme,34751,35847,70598
658307,80001,Africo,1510,1441,2951
658409,80002,Agnana Calabra,273,249,522
658511,80003,Anoia,1013,1126,2139
658613,80004,Antonimina,650,624,1274
658715,80005,Ardore,2489,2601,5090
658817,80006,Bagaladi,463,521,984
658919,80007,Bagnara Calabra,4943,5036,9979
659021,80008,Benestare,1281,1252,2533
659123,80009,Bianco,2080,2187,4267
659225,80010,Bivongi,644,657,1301
659327,80011,Bova,225,206,431
659429,80012,Bovalino,4406,4537,8943
659531,80013,Bova Marina,2051,2149,4200
659633,80014,Brancaleone,1736,1806,3542
659735,80015,Bruzzano Zeffirio,516,578,1094
659837,80016,Calanna,412,461,873
659939,80017,Camini,368,412,780
660041,80018,Campo Calabro,2232,2308,4540
660143,80019,Candidoni,205,207,412
660245,80020,Canolo,349,350,699
660347,80021,Caraffa del Bianco,240,265,505
660449,80022,Cardeto,714,807,1521
660551,80023,Careri,1133,1152,2285
660653,80024,Casignana,345,392,737
660755,80025,Caulonia,3558,3561,7119
660857,80026,Ciminà,280,278,558
660959,80027,Cinquefrondi,3174,3331,6505
661061,80028,Cittanova,4962,5285,10247
661163,80029,Condofuri,2462,2536,4998
661265,80030,Cosoleto,424,428,852
661367,80031,Delianuova,1587,1712,3299
661469,80032,Feroleto della Chiesa,799,827,1626
661571,80033,Ferruzzano,373,416,789
661673,80034,Fiumara,442,473,915
661775,80035,Galatro,781,843,1624
661877,80036,Gerace,1295,1261,2556
661979,80037,Giffone,890,891,1781
662081,80038,Gioia Tauro,9964,10114,20078
662183,80039,Gioiosa Ionica,3487,3627,7114
662285,80040,Grotteria,1502,1578,3080
662387,80041,Laganadi,200,216,416
662489,80042,Laureana di Borrello,2423,2582,5005
662591,80043,Locri,6002,6419,12421
662693,80044,Mammola,1282,1407,2689
662795,80045,Marina di Gioiosa Ionica,3238,3303,6541
662897,80046,Maropati,714,738,1452
662999,80047,Martone,253,253,506
663101,80048,Melicuccà,422,478,900
663203,80049,Melicucco,2486,2521,5007
663305,80050,Melito di Porto Salvo,5512,5705,11217
663407,80051,Molochio,1211,1243,2454
663509,80052,Monasterace,1793,1788,3581
663611,80053,Montebello Jonico,3045,3116,6161
663713,80054,Motta San Giovanni,2954,3089,6043
663815,80055,Oppido Mamertina,2571,2633,5204
663917,80056,Palizzi,1156,1237,2393
664019,80057,Palmi,9068,9676,18744
664121,80058,Pazzano,267,258,525
664223,80059,Placanica,550,591,1141
664325,80060,Platì,1935,1863,3798
664427,80061,Polistena,5037,5324,10361
664529,80062,Portigliola,558,600,1158
664631,80063,Reggio di Calabria,86430,93939,180369
664733,80064,Riace,1179,1142,2321
664835,80065,Rizziconi,3877,3898,7775
664937,80066,Roccaforte del Greco,208,217,425
665039,80067,Roccella Ionica,3029,3387,6416
665141,80068,Roghudi,500,500,1000
665243,80069,Rosarno,7383,7413,14796
665345,80070,Samo,381,396,777
665447,80071,San Giorgio Morgeto,1449,1581,3030
665549,80072,San Giovanni di Gerace,216,245,461
665651,80073,San Lorenzo,1269,1277,2546
665753,80074,San Luca,1850,1868,3718
665855,80075,San Pietro di Caridà,552,592,1144
665957,80076,San Procopio,261,268,529
666059,80077,San Roberto,830,823,1653
666161,80078,Santa Cristina d'Aspromonte,428,420,848
666263,80079,Sant'Agata del Bianco,284,305,589
666365,80080,Sant'Alessio in Aspromonte,166,161,327
666467,80081,Sant'Eufemia d'Aspromonte,1957,2052,4009
666569,80082,Sant'Ilario dello Ionio,688,717,1405
666671,80083,Santo Stefano in Aspromonte,687,580,1267
666773,80084,Scido,430,460,890
666875,80085,Scilla,2341,2511,4852
666977,80086,Seminara,1298,1358,2656
667079,80087,Serrata,395,408,803
667181,80088,Siderno,8937,9210,18147
667283,80089,Sinopoli,1003,995,1998
667385,80090,Staiti,105,120,225
667487,80091,Stignano,703,657,1360
667589,80092,Stilo,1301,1240,2541
667691,80093,Taurianova,7520,7938,15458
667793,80094,Terranova Sappo Minulio,259,253,512
667895,80095,Varapodio,1025,1044,2069
667997,80096,Villa San Giovanni,6628,6906,13534
668099,80097,San Ferdinando,2924,2175,5099
668201,81001,Alcamo,22237,22953,45190
668303,81002,Buseto Palizzolo,1387,1532,2919
668405,81003,Calatafimi-Segesta,3190,3305,6495
668507,81004,Campobello di Mazara,5847,5898,11745
668609,81005,Castellammare del Golfo,7551,7607,15158
668711,81006,Castelvetrano,15259,15892,31151
668813,81007,Custonaci,2766,2730,5496
668915,81008,Erice,13297,14168,27465
669017,81009,Favignana,2218,2119,4337
669119,81010,Gibellina,1861,2120,3981
669221,81011,Marsala,40642,41998,82640
669323,81012,Mazara del Vallo,25494,26059,51553
669425,81013,Paceco,5424,5797,11221
669527,81014,Pantelleria,3820,3882,7702
669629,81015,Partanna,5024,5313,10337
669731,81016,Poggioreale,726,752,1478
669833,81017,Salaparuta,783,856,1639
669935,81018,Salemi,5235,5297,10532
670037,81019,Santa Ninfa,2387,2582,4969
670139,81020,San Vito Lo Capo,2347,2420,4767
670241,81021,Trapani,32623,34908,67531
670343,81022,Valderice,6084,6029,12113
670445,81023,Vita,954,992,1946
670547,81024,Petrosino,4148,3979,8127
670649,82001,Alia,1660,1815,3475
670751,82002,Alimena,892,1025,1917
670853,82003,Aliminusa,599,574,1173
670955,82004,Altavilla Milicia,4163,4186,8349
671057,82005,Altofonte,4952,5175,10127
671159,82006,Bagheria,26626,28088,54714
671261,82007,Balestrate,3092,3399,6491
671363,82008,Baucina,978,961,1939
671465,82009,Belmonte Mezzagno,5543,5695,11238
671567,82010,Bisacquino,2140,2247,4387
671669,82011,Bolognetta,2090,2104,4194
671771,82012,Bompietro,604,698,1302
671873,82013,Borgetto,3680,3679,7359
671975,82014,Caccamo,4005,4076,8081
672077,82015,Caltavuturo,1871,1996,3867
672179,82016,Campofelice di Fitalia,238,240,478
672281,82017,Campofelice di Roccella,3748,3897,7645
672383,82018,Campofiorito,609,628,1237
672485,82019,Camporeale,1580,1613,3193
672587,82020,Capaci,5692,5912,11604
672689,82021,Carini,19465,19584,39049
672791,82022,Castelbuono,4230,4389,8619
672893,82023,Casteldaccia,5745,5943,11688
672995,82024,Castellana Sicula,1547,1709,3256
673097,82025,Castronovo di Sicilia,1441,1551,2992
673199,82026,Cefalà Diana,493,515,1008
673301,82027,Cefalù,6973,7336,14309
673403,82028,Cerda,2517,2613,5130
673505,82029,Chiusa Sclafani,1286,1442,2728
673607,82030,Ciminna,1749,1880,3629
673709,82031,Cinisi,6044,6220,12264
673811,82032,Collesano,1911,2042,3953
673913,82033,Contessa Entellina,820,848,1668
674015,82034,Corleone,5399,5609,11008
674117,82035,Ficarazzi,6378,6628,13006
674219,82036,Gangi,3155,3410,6565
674321,82037,Geraci Siculo,861,927,1788
674423,82038,Giardinello,1122,1162,2284
674525,82039,Giuliana,925,910,1835
674627,82040,Godrano,602,570,1172
674729,82041,Gratteri,440,470,910
674831,82042,Isnello,722,743,1465
674933,82043,Isola delle Femmine,3594,3561,7155
675035,82044,Lascari,1745,1872,3617
675137,82045,Lercara Friddi,3190,3536,6726
675239,82046,Marineo,3179,3311,6490
675341,82047,Mezzojuso,1398,1446,2844
675443,82048,Misilmeri,14552,14830,29382
675545,82049,Monreale,19144,19740,38884
675647,82050,Montelepre,2932,3148,6080
675749,82051,Montemaggiore Belsito,1513,1666,3179
675851,82052,Palazzo Adriano,929,1050,1979
675953,82053,Palermo,316812,346589,663401
676055,82054,Partinico,15859,15981,31840
676157,82055,Petralia Soprana,1549,1617,3166
676259,82056,Petralia Sottana,1262,1415,2677
676361,82057,Piana degli Albanesi,3097,2973,6070
676463,82058,Polizzi Generosa,1525,1671,3196
676565,82059,Pollina,1438,1490,2928
676667,82060,Prizzi,2239,2406,4645
676769,82061,Roccamena,690,760,1450
676871,82062,Roccapalumba,1153,1236,2389
676973,82063,San Cipirello,2582,2711,5293
677075,82064,San Giuseppe Jato,4203,4351,8554
677177,82065,San Mauro Castelverde,765,777,1542
677279,82066,Santa Cristina Gela,509,495,1004
677381,82067,Santa Flavia,5496,5712,11208
677483,82068,Sciara,1377,1401,2778
677585,82069,Sclafani Bagni,202,216,418
677687,82070,Termini Imerese,12613,13248,25861
677789,82071,Terrasini,6238,6450,12688
677891,82072,Torretta,2106,2200,4306
677993,82073,Trabia,5350,5146,10496
678095,82074,Trappeto,1554,1586,3140
678197,82075,Ustica,660,658,1318
678299,82076,Valledolmo,1649,1805,3454
678401,82077,Ventimiglia di Sicilia,918,964,1882
678503,82078,Vicari,1258,1365,2623
678605,82079,Villabate,9778,10182,19960
678707,82080,Villafrati,1610,1691,3301
678809,82081,Scillato,285,327,612
678911,82082,Blufi,457,499,956
679013,83001,Alcara li Fusi,873,988,1861
679115,83002,Alì,362,372,734
679217,83003,Alì Terme,1175,1256,2431
679319,83004,Antillo,437,431,868
679421,83005,Barcellona Pozzo di Gotto,20007,21214,41221
679523,83006,Basicò,285,309,594
679625,83007,Brolo,2756,3017,5773
679727,83008,Capizzi,1483,1568,3051
679829,83009,Capo d'Orlando,6279,7016,13295
679931,83010,Capri Leone,2119,2295,4414
680033,83011,Caronia,1549,1665,3214
680135,83012,Casalvecchio Siculo,405,370,775
680237,83013,Castel di Lucio,613,647,1260
680339,83014,Castell'Umberto,1448,1566,3014
680441,83015,Castelmola,546,572,1118
680543,83016,Castroreale,1143,1227,2370
680645,83017,Cesarò,1128,1183,2311
680747,83018,Condrò,232,254,486
680849,83019,Falcone,1342,1426,2768
680951,83020,Ficarra,670,724,1394
681053,83021,Fiumedinisi,680,682,1362
681155,83022,Floresta,234,237,471
681257,83023,Fondachelli-Fantina,600,478,1078
681359,83024,Forza d'Agrò,432,455,887
681461,83025,Francavilla di Sicilia,1821,1968,3789
681563,83026,Frazzanò,310,347,657
681665,83027,Furci Siculo,1575,1723,3298
681767,83028,Furnari,1877,1943,3820
681869,83029,Gaggi,1535,1669,3204
681971,83030,Galati Mamertino,1135,1329,2464
682073,83031,Gallodoro,166,181,347
682175,83032,Giardini-Naxos,4407,4918,9325
682277,83033,Gioiosa Marea,3348,3556,6904
682379,83034,Graniti,743,726,1469
682481,83035,Gualtieri Sicaminò,806,904,1710
682583,83036,Itala,735,800,1535
682685,83037,Leni,363,343,706
682787,83038,Letojanni,1364,1458,2822
682889,83039,Librizzi,777,839,1616
682991,83040,Limina,351,410,761
683093,83041,Lipari,6553,6268,12821
683195,83042,Longi,679,726,1405
683297,83043,Malfa,507,501,1008
683399,83044,Malvagna,323,343,666
683501,83045,Mandanici,275,294,569
683603,83046,Mazzarrà Sant'Andrea,756,737,1493
683705,83047,Merì,1134,1185,2319
683807,83048,Messina,111558,120997,232555
683909,83049,Milazzo,15039,15989,31028
684011,83050,Militello Rosmarino,623,646,1269
684113,83051,Mirto,454,484,938
684215,83052,Mistretta,2138,2452,4590
684317,83053,Moio Alcantara,339,375,714
684419,83054,Monforte San Giorgio,1296,1389,2685
684521,83055,Mongiuffi Melia,288,294,582
684623,83056,Montagnareale,747,794,1541
684725,83057,Montalbano Elicona,1038,1123,2161
684827,83058,Motta Camastra,419,406,825
684929,83059,Motta d'Affermo,344,356,700
685031,83060,Naso,1762,1905,3667
685133,83061,Nizza di Sicilia,1767,1874,3641
685235,83062,Novara di Sicilia,617,667,1284
685337,83063,Oliveri,1027,1086,2113
685439,83064,Pace del Mela,3070,3172,6242
685541,83065,Pagliara,540,600,1140
685643,83066,Patti,6351,6864,13215
685745,83067,Pettineo,625,657,1282
685847,83068,Piraino,1916,1988,3904
685949,83069,Raccuja,461,501,962
686051,83070,Reitano,393,379,772
686153,83071,Roccafiorita,87,99,186
686255,83072,Roccalumera,1993,2126,4119
686357,83073,Roccavaldina,533,547,1080
686459,83074,Roccella Valdemone,312,315,627
686561,83075,Rodì Milici,990,1016,2006
686663,83076,Rometta,3255,3343,6598
686765,83077,San Filippo del Mela,3425,3542,6967
686867,83078,San Fratello,1733,1790,3523
686969,83079,San Marco d'Alunzio,910,979,1889
687071,83080,San Pier Niceto,1342,1391,2733
687173,83081,San Piero Patti,1334,1441,2775
687275,83082,San Salvatore di Fitalia,567,676,1243
687377,83083,Santa Domenica Vittoria,461,469,930
687479,83084,Sant'Agata di Militello,5780,6525,12305
687581,83085,Sant'Alessio Siculo,729,803,1532
687683,83086,Santa Lucia del Mela,2252,2330,4582
687785,83087,Santa Marina Salina,473,411,884
687887,83088,Sant'Angelo di Brolo,1442,1530,2972
687989,83089,Santa Teresa di Riva,4505,4889,9394
688091,83090,San Teodoro,647,690,1337
688193,83091,Santo Stefano di Camastra,2203,2445,4648
688295,83092,Saponara,1886,1979,3865
688397,83093,Savoca,854,907,1761
688499,83094,Scaletta Zanclea,941,1031,1972
688601,83095,Sinagra,1309,1319,2628
688703,83096,Spadafora,2376,2563,4939
688805,83097,Taormina,5220,5611,10831
688907,83098,Torregrotta,3508,3855,7363
689009,83099,Tortorici,3035,3120,6155
689111,83100,Tripi,390,449,839
689213,83101,Tusa,1370,1415,2785
689315,83102,Ucria,468,530,998
689417,83103,Valdina,636,672,1308
689519,83104,Venetico,1913,2101,4014
689621,83105,Villafranca Tirrena,3960,4430,8390
689723,83106,Terme Vigliatore,3631,3713,7344
689825,83107,Acquedolci,2734,2878,5612
689927,83108,Torrenova,2192,2282,4474
690029,84001,Agrigento,28973,29983,58956
690131,84002,Alessandria della Rocca,1341,1462,2803
690233,84003,Aragona,4570,4792,9362
690335,84004,Bivona,1706,1819,3525
690437,84005,Burgio,1262,1343,2605
690539,84006,Calamonaci,628,665,1293
690641,84007,Caltabellotta,1663,1839,3502
690743,84008,Camastra,987,1022,2009
690845,84009,Cammarata,3073,3056,6129
690947,84010,Campobello di Licata,4752,4985,9737
691049,84011,Canicattì,17292,18486,35778
691151,84012,Casteltermini,3763,4095,7858
691253,84013,Castrofilippo,1376,1489,2865
691355,84014,Cattolica Eraclea,1741,1850,3591
691457,84015,Cianciana,1593,1779,3372
691559,84016,Comitini,452,478,930
691661,84017,Favara,15580,16479,32059
691763,84018,Grotte,2618,2938,5556
691865,84019,Joppolo Giancaxio,568,610,1178
691967,84020,Lampedusa e Linosa,3414,3142,6556
692069,84021,Licata,17942,18563,36505
692171,84022,Lucca Sicula,854,905,1759
692273,84023,Menfi,6019,6394,12413
692375,84024,Montallegro,1215,1279,2494
692477,84025,Montevago,1446,1483,2929
692579,84026,Naro,3587,3892,7479
692681,84027,Palma di Montechiaro,10735,11768,22503
692783,84028,Porto Empedocle,8128,8385,16513
692885,84029,Racalmuto,3930,4138,8068
692987,84030,Raffadali,6054,6525,12579
693089,84031,Ravanusa,5475,5852,11327
693191,84032,Realmonte,2248,2326,4574
693293,84033,Ribera,9006,9705,18711
693395,84034,Sambuca di Sicilia,2892,2878,5770
693497,84035,San Biagio Platani,1465,1674,3139
693599,84036,San Giovanni Gemini,3934,3967,7901
693701,84037,Santa Elisabetta,1126,1182,2308
693803,84038,Santa Margherita di Belice,3053,3274,6327
693905,84039,Sant'Angelo Muxaro,614,677,1291
694007,84040,Santo Stefano Quisquina,2142,2299,4441
694109,84041,Sciacca,19624,20717,40341
694211,84042,Siculiana,2211,2245,4456
694313,84043,Villafranca Sicula,658,720,1378
694415,85001,Acquaviva Platani,449,479,928
694517,85002,Bompensiere,270,272,542
694619,85003,Butera,2232,2309,4541
694721,85004,Caltanissetta,29379,31685,61064
694823,85005,Campofranco,1378,1559,2937
694925,85006,Delia,1950,2173,4123
695027,85007,Gela,36099,37755,73854
695129,85008,Marianopoli,853,922,1775
695231,85009,Mazzarino,5555,6078,11633
695333,85010,Milena,1418,1506,2924
695435,85011,Montedoro,704,798,1502
695537,85012,Mussomeli,5000,5405,10405
695639,85013,Niscemi,13122,13505,26627
695741,85014,Resuttano,935,976,1911
695843,85015,Riesi,5354,5937,11291
695945,85016,San Cataldo,10820,11573,22393
696047,85017,Santa Caterina Villarmosa,2411,2714,5125
696149,85018,Serradifalco,2800,3091,5891
696251,85019,Sommatino,3210,3567,6777
696353,85020,Sutera,617,703,1320
696455,85021,Vallelunga Pratameno,1588,1743,3331
696557,85022,Villalba,747,817,1564
696659,86001,Agira,4010,4122,8132
696761,86002,Aidone,2452,2373,4825
696863,86003,Assoro,2490,2546,5036
696965,86004,Barrafranca,6034,6766,12800
697067,86005,Calascibetta,2100,2279,4379
697169,86006,Catenanuova,2293,2403,4696
697271,86007,Centuripe,2632,2729,5361
697373,86008,Cerami,972,980,1952
697475,86009,Enna,12900,14104,27004
697577,86010,Gagliano Castelferrato,1692,1826,3518
697679,86011,Leonforte,6271,6691,12962
697781,86012,Nicosia,6545,6870,13415
697883,86013,Nissoria,1508,1493,3001
697985,86014,Piazza Armerina,10643,11083,21726
698087,86015,Pietraperzia,3190,3578,6768
698189,86016,Regalbuto,3543,3550,7093
698291,86017,Sperlinga,357,380,737
698393,86018,Troina,4406,4688,9094
698495,86019,Valguarnera Caropepe,3555,4002,7557
698597,86020,Villarosa,2260,2472,4732
698699,87001,Aci Bonaccorsi,1684,1864,3548
698801,87002,Aci Castello,8826,9654,18480
698903,87003,Aci Catena,14333,14740,29073
699005,87004,Acireale,25223,26842,52065
699107,87005,Aci Sant'Antonio,8990,9145,18135
699209,87006,Adrano,17129,18301,35430
699311,87007,Belpasso,13935,14148,28083
699413,87008,Biancavilla,11528,12304,23832
699515,87009,Bronte,9038,9818,18856
699617,87010,Calatabiano,2541,2656,5197
699719,87011,Caltagirone,18534,19349,37883
699821,87012,Camporotondo Etneo,2620,2529,5149
699923,87013,Castel di Iudica,2185,2310,4495
700025,87014,Castiglione di Sicilia,1524,1605,3129
700127,87015,Catania,150191,161393,311584
700229,87016,Fiumefreddo di Sicilia,4503,4935,9438
700331,87017,Giarre,13230,14214,27444
700433,87018,Grammichele,6431,6721,13152
700535,87019,Gravina di Catania,12148,13276,25424
700637,87020,Licodia Eubea,1554,1524,3078
700739,87021,Linguaglossa,2557,2713,5270
700841,87022,Maletto,1818,1948,3766
700943,87023,Mascali,7096,7241,14337
701045,87024,Mascalucia,15685,16515,32200
701147,87025,Militello in Val di Catania,3553,3633,7186
701249,87026,Milo,531,523,1054
701351,87027,Mineo,2798,2536,5334
701453,87028,Mirabella Imbaccari,2193,2489,4682
701555,87029,Misterbianco,24457,25580,50037
701657,87030,Motta Sant'Anastasia,5935,6243,12178
701759,87031,Nicolosi,3703,3781,7484
701861,87032,Palagonia,8104,8384,16488
701963,87033,Paternò,23197,24403,47600
702065,87034,Pedara,7307,7366,14673
702167,87035,Piedimonte Etneo,1976,1974,3950
702269,87036,Raddusa,1491,1558,3049
702371,87037,Ramacca,5467,5359,10826
702473,87038,Randazzo,5102,5610,10712
702575,87039,Riposto,7135,7475,14610
702677,87040,San Cono,1312,1335,2647
702779,87041,San Giovanni la Punta,11241,12321,23562
702881,87042,San Gregorio di Catania,5658,6153,11811
702983,87043,San Michele di Ganzaria,1566,1630,3196
703085,87044,San Pietro Clarenza,3976,4026,8002
703187,87045,Sant'Agata li Battiati,4372,5039,9411
703289,87046,Sant'Alfio,759,811,1570
703391,87047,Santa Maria di Licodia,3758,3924,7682
703493,87048,Santa Venerina,4183,4350,8533
703595,87049,Scordia,8398,8489,16887
703697,87050,Trecastagni,5474,5618,11092
703799,87051,Tremestieri Etneo,9596,10671,20267
703901,87052,Valverde,3888,4013,7901
704003,87053,Viagrande,4340,4443,8783
704105,87054,Vizzini,2913,3116,6029
704207,87055,Zafferana Etnea,4792,4833,9625
704309,87056,Mazzarrone,1987,2039,4026
704411,87057,Maniace,1881,1866,3747
704513,87058,Ragalna,2056,1964,4020
704615,88001,Acate,6248,5183,11431
704717,88002,Chiaramonte Gulfi,4099,4029,8128
704819,88003,Comiso,14882,15191,30073
704921,88004,Giarratana,1424,1499,2923
705023,88005,Ispica,8321,7996,16317
705125,88006,Modica,26186,28082,54268
705227,88007,Monterosso Almo,1431,1511,2942
705329,88008,Pozzallo,9589,9838,19427
705431,88009,Ragusa,35506,37867,73373
705533,88010,Santa Croce Camerina,5862,5147,11009
705635,88011,Scicli,13280,13682,26962
705737,88012,Vittoria,32187,31853,64040
705839,89001,Augusta,17782,18090,35872
705941,89002,Avola,15362,15856,31218
706043,89003,Buccheri,913,1011,1924
706145,89004,Buscemi,514,493,1007
706247,89005,Canicattini Bagni,3331,3602,6933
706349,89006,Carlentini,8571,9058,17629
706451,89007,Cassaro,366,403,769
706553,89008,Ferla,1182,1243,2425
706655,89009,Floridia,11235,11430,22665
706757,89010,Francofonte,6121,6332,12453
706859,89011,Lentini,11202,11899,23101
706961,89012,Melilli,6971,6640,13611
707063,89013,Noto,12132,12060,24192
707165,89014,Pachino,11198,10946,22144
707267,89015,Palazzolo Acreide,4136,4433,8569
707369,89016,Rosolini,10436,10762,21198
707471,89017,Siracusa,59363,61808,121171
707573,89018,Solarino,4050,4047,8097
707675,89019,Sortino,4194,4292,8486
707777,89020,Portopalo di Capo Passero,1977,1960,3937
707879,89021,Priolo Gargallo,5835,5988,11823
707981,90001,Aggius,690,767,1457
708083,90002,Alà dei Sardi,923,933,1856
708185,90003,Alghero,21185,22746,43931
708287,90004,Anela,316,302,618
708389,90005,Ardara,392,382,774
708491,90006,Arzachena,6987,6848,13835
708593,90007,Banari,278,279,557
708695,90008,Benetutti,876,928,1804
708797,90009,Berchidda,1344,1371,2715
708899,90010,Bessude,194,214,408
709001,90011,Bonnanaro,445,505,950
709103,90012,Bono,1700,1794,3494
709205,90013,Bonorva,1659,1681,3340
709307,90014,Bortigiadas,369,383,752
709409,90015,Borutta,131,146,277
709511,90016,Bottidda,341,338,679
709613,90017,Buddusò,1931,1891,3822
709715,90018,Bultei,447,453,900
709817,90019,Bulzi,263,239,502
709919,90020,Burgos,451,445,896
710021,90021,Calangianus,2030,2019,4049
710123,90022,Cargeghe,328,313,641
710225,90023,Castelsardo,2952,2941,5893
710327,90024,Cheremule,210,216,426
710429,90025,Chiaramonti,797,816,1613
710531,90026,Codrongianos,651,656,1307
710633,90027,Cossoine,420,410,830
710735,90028,Esporlatu,180,202,382
710837,90029,Florinas,742,765,1507
710939,90030,Giave,260,252,512
711041,90031,Illorai,390,440,830
711143,90032,Ittireddu,254,232,486
711245,90033,Ittiri,4199,4265,8464
711347,90034,Laerru,437,442,879
711449,90035,La Maddalena,5576,5616,11192
711551,90036,Luogosanto,922,927,1849
711653,90037,Luras,1205,1284,2489
711755,90038,Mara,280,299,579
711857,90039,Martis,245,246,491
711959,90040,Monteleone Rocca Doria,41,58,99
712061,90041,Monti,1209,1183,2392
712163,90042,Mores,946,954,1900
712265,90043,Muros,431,426,857
712367,90044,Nughedu San Nicolò,392,402,794
712469,90045,Nule,677,674,1351
712571,90046,Nulvi,1340,1375,2715
712673,90047,Olbia,30078,30653,60731
712775,90048,Olmedo,2079,2098,4177
712877,90049,Oschiri,1605,1590,3195
712979,90050,Osilo,1470,1508,2978
713081,90051,Ossi,2787,2920,5707
713183,90052,Ozieri,5212,5242,10454
713285,90053,Padria,313,319,632
713387,90054,Palau,2121,2075,4196
713489,90055,Pattada,1514,1476,2990
713591,90056,Perfugas,1177,1176,2353
713693,90057,Ploaghe,2246,2235,4481
713795,90058,Porto Torres,10943,11183,22126
713897,90059,Pozzomaggiore,1271,1298,2569
713999,90060,Putifigari,362,358,720
714101,90061,Romana,254,283,537
714203,90062,Aglientu,646,613,1259
714305,90063,Santa Teresa Gallura,2750,2627,5377
714407,90064,Sassari,61265,65605,126870
714509,90065,Sedini,627,705,1332
714611,90066,Semestene,65,79,144
714713,90067,Sennori,3571,3598,7169
714815,90068,Siligo,406,449,855
714917,90069,Sorso,7511,7264,14775
715019,90070,Tempio Pausania,6954,6948,13902
715121,90071,Thiesi,1436,1460,2896
715223,90072,Tissi,1228,1178,2406
715325,90073,Torralba,472,478,950
715427,90074,Trinità d'Agultu e Vignola,1130,1121,2251
715529,90075,Tula,773,746,1519
715631,90076,Uri,1502,1442,2944
715733,90077,Usini,2192,2146,4338
715835,90078,Villanova Monteleone,1105,1147,2252
715937,90079,Valledoria,2212,2133,4345
716039,90080,Telti,1167,1152,2319
716141,90081,Badesi,905,957,1862
716243,90082,Viddalba,841,831,1672
716345,90083,Golfo Aranci,1207,1273,2480
716447,90084,Loiri Porto San Paolo,1761,1763,3524
716549,90085,Sant'Antonio di Gallura,742,757,1499
716651,90086,Tergu,296,316,612
716753,90087,Santa Maria Coghinas,699,675,1374
716855,90088,Erula,382,350,732
716957,90089,Stintino,825,791,1616
717059,90090,Padru,1063,1028,2091
717161,90091,Budoni,2584,2657,5241
717263,90092,San Teodoro,2537,2488,5025
717365,91001,Aritzo,646,615,1261
717467,91002,Arzana,1188,1168,2356
717569,91003,Atzara,565,540,1105
717671,91004,Austis,388,409,797
717773,91005,Bari Sardo,1927,2047,3974
717875,91006,Baunei,1761,1828,3589
717977,91007,Belvì,295,292,587
718079,91008,Birori,269,264,533
718181,91009,Bitti,1323,1439,2762
718283,91010,Bolotana,1184,1362,2546
718385,91011,Borore,1004,1068,2072
718487,91012,Bortigali,617,699,1316
718589,91016,Desulo,1114,1163,2277
718691,91017,Dorgali,4323,4233,8556
718793,91018,Dualchi,294,312,606
718895,91019,Elini,272,286,558
718997,91024,Fonni,1861,1977,3838
719099,91025,Gadoni,365,391,756
719201,91026,Gairo,695,694,1389
719303,91027,Galtellì,1210,1234,2444
719405,91028,Gavoi,1298,1310,2608
719507,91031,Girasole,675,649,1324
719609,91032,Ilbono,1059,1060,2119
719711,91033,Irgoli,1164,1128,2292
719813,91035,Jerzu,1565,1591,3156
719915,91037,Lanusei,2643,2656,5299
720017,91038,Lei,245,247,492
720119,91039,Loceri,641,662,1303
720221,91040,Loculi,275,239,514
720323,91041,Lodè,845,789,1634
720425,91042,Lotzorai,1020,1108,2128
720527,91043,Lula,694,666,1360
720629,91044,Macomer,4839,5097,9936
720731,91046,Mamoiada,1216,1282,2498
720833,91047,Meana Sardo,864,871,1735
720935,91050,Noragugume,147,148,295
721037,91051,Nuoro,17250,18904,36154
721139,91055,Oliena,3422,3566,6988
721241,91056,Ollolai,629,640,1269
721343,91057,Olzai,439,406,845
721445,91058,Onanì,176,187,363
721547,91059,Onifai,343,375,718
721649,91060,Oniferi,441,451,892
721751,91061,Orani,1407,1428,2835
721853,91062,Orgosolo,2114,2041,4155
721955,91063,Orosei,3501,3580,7081
722057,91064,Orotelli,985,1006,1991
722159,91066,Ortueri,572,551,1123
722261,91067,Orune,1149,1137,2286
722363,91068,Osidda,116,125,241
722465,91069,Osini,396,376,772
722567,91070,Ottana,1122,1141,2263
722669,91071,Ovodda,810,793,1603
722771,91072,Perdasdefogu,923,914,1837
722873,91073,Posada,1535,1488,3023
722975,91077,Sarule,834,841,1675
723077,91083,Silanus,1035,1049,2084
723179,91084,Sindia,811,882,1693
723281,91085,Siniscola,5776,5668,11444
723383,91086,Sorgono,808,813,1621
723485,91088,Talana,475,519,994
723587,91089,Tertenia,1965,1954,3919
723689,91090,Teti,360,307,667
723791,91091,Tiana,239,235,474
723893,91093,Tonara,995,973,1968
723995,91094,Torpè,1450,1390,2840
724097,91095,Tortolì,5402,5649,11051
724199,91097,Triei,570,536,1106
724301,91098,Ulassai,698,734,1432
724403,91099,Urzulei,585,611,1196
724505,91100,Ussassai,268,264,532
724607,91101,Villagrande Strisaili,1579,1545,3124
724709,91103,Cardedu,938,1006,1944
724811,91104,Lodine,171,161,332
724913,92003,Assemini,13120,13518,26638
725015,92009,Cagliari,72093,82174,154267
725117,92011,Capoterra,11654,11811,23465
725219,92015,Decimomannu,4158,4125,8283
725321,92037,Maracalagonis,4091,3924,8015
725423,92050,Pula,3716,3604,7320
725525,92051,Quartu Sant'Elena,34624,35907,70531
725627,92066,Sarroch,2645,2621,5266
725729,92068,Selargius,13764,14699,28463
725831,92074,Sestu,10620,10396,21016
725933,92075,Settimo San Pietro,3372,3438,6810
726035,92080,Sinnai,8827,8820,17647
726137,92090,Uta,4452,4274,8726
726239,92099,Villa San Pietro,1087,1063,2150
726341,92105,Quartucciu,6473,6702,13175
726443,92108,Elmas,4760,4787,9547
726545,92109,Monserrato,9411,10308,19719
726647,93001,Andreis,126,124,250
726749,93002,Arba,662,644,1306
726851,93004,Aviano,4587,4602,9189
726953,93005,Azzano Decimo,7783,7948,15731
727055,93006,Barcis,126,118,244
727157,93007,Brugnera,4673,4660,9333
727259,93008,Budoia,1278,1273,2551
727361,93009,Caneva,3088,3235,6323
727463,93010,Casarsa della Delizia,4197,4193,8390
727565,93011,Castelnovo del Friuli,436,425,861
727667,93012,Cavasso Nuovo,756,778,1534
727769,93013,Chions,2550,2638,5188
727871,93014,Cimolais,188,169,357
727973,93015,Claut,437,475,912
728075,93016,Clauzetto,198,185,383
728177,93017,Cordenons,8870,9331,18201
728279,93018,Cordovado,1341,1392,2733
728381,93019,Erto e Casso,185,187,372
728483,93020,Fanna,776,789,1565
728585,93021,Fiume Veneto,5756,5990,11746
728687,93022,Fontanafredda,6243,6399,12642
728789,93024,Frisanco,304,297,601
728891,93025,Maniago,5803,6015,11818
728993,93026,Meduno,777,760,1537
729095,93027,Montereale Valcellina,2104,2229,4333
729197,93028,Morsano al Tagliamento,1349,1397,2746
729299,93029,Pasiano di Pordenone,3878,3896,7774
729401,93030,Pinzano al Tagliamento,733,781,1514
729503,93031,Polcenigo,1521,1626,3147
729605,93032,Porcia,7375,7825,15200
729707,93033,Pordenone,24605,26762,51367
729809,93034,Prata di Pordenone,4224,4204,8428
729911,93035,Pravisdomini,1785,1728,3513
730013,93036,Roveredo in Piano,2928,3060,5988
730115,93037,Sacile,9681,10250,19931
730217,93038,San Giorgio della Richinvelda,2420,2218,4638
730319,93039,San Martino al Tagliamento,717,727,1444
730421,93040,San Quirino,2137,2148,4285
730523,93041,San Vito al Tagliamento,7367,7756,15123
730625,93042,Sequals,1089,1129,2218
730727,93043,Sesto al Reghena,3203,3200,6403
730829,93044,Spilimbergo,5901,6220,12121
730931,93045,Tramonti di Sopra,144,146,290
731033,93046,Tramonti di Sotto,191,170,361
731135,93047,Travesio,876,899,1775
731237,93049,Vito d'Asio,368,353,721
731339,93050,Vivaro,677,647,1324
731441,93051,Zoppola,4277,4240,8517
731543,93052,Vajont,852,824,1676
731645,93053,Valvasone Arzene,1924,2005,3929
731747,94001,Acquaviva d'Isernia,203,199,402
731849,94002,Agnone,2421,2476,4897
731951,94003,Bagnoli del Trigno,345,346,691
732053,94004,Belmonte del Sannio,322,386,708
732155,94005,Cantalupo nel Sannio,417,328,745
732257,94006,Capracotta,449,415,864
732359,94007,Carovilli,654,658,1312
732461,94008,Carpinone,521,579,1100
732563,94009,Castel del Giudice,159,153,312
732665,94010,Castelpetroso,816,802,1618
732767,94011,Castelpizzuto,91,68,159
732869,94012,Castel San Vincenzo,243,242,485
732971,94013,Castelverrino,58,44,102
733073,94014,Cerro al Volturno,623,617,1240
733175,94015,Chiauci,114,99,213
733277,94016,Civitanova del Sannio,455,465,920
733379,94017,Colli a Volturno,660,664,1324
733481,94018,Conca Casale,89,90,179
733583,94019,Filignano,322,304,626
733685,94020,Forlì del Sannio,324,349,673
733787,94021,Fornelli,936,947,1883
733889,94022,Frosolone,1564,1520,3084
733991,94023,Isernia,10459,11290,21749
734093,94024,Longano,328,347,675
734195,94025,Macchia d'Isernia,580,513,1093
734297,94026,Macchiagodena,916,883,1799
734399,94027,Miranda,492,519,1011
734501,94028,Montaquila,1193,1139,2332
734603,94029,Montenero Val Cocchiara,270,243,513
734705,94030,Monteroduni,1017,1101,2118
734807,94031,Pesche,858,783,1641
734909,94032,Pescolanciano,421,422,843
735011,94033,Pescopennataro,130,123,253
735113,94034,Pettoranello del Molise,234,207,441
735215,94035,Pietrabbondante,366,341,707
735317,94036,Pizzone,164,141,305
735419,94037,Poggio Sannita,318,307,625
735521,94038,Pozzilli,1142,1155,2297
735623,94039,Rionero Sannitico,573,522,1095
735725,94040,Roccamandolfi,484,439,923
735827,94041,Roccasicura,258,262,520
735929,94042,Rocchetta a Volturno,546,536,1082
736031,94043,San Pietro Avellana,241,243,484
736133,94044,Sant'Agapito,741,702,1443
736235,94045,Santa Maria del Molise,359,346,705
736337,94046,Sant'Angelo del Pesco,185,174,359
736439,94047,Sant'Elena Sannita,163,135,298
736541,94048,Scapoli,340,323,663
736643,94049,Sessano del Molise,352,365,717
736745,94050,Sesto Campano,1091,1163,2254
736847,94051,Vastogirardi,339,340,679
736949,94052,Venafro,5484,5734,11218
737051,95001,Abbasanta,1322,1356,2678
737153,95002,Aidomaggiore,199,232,431
737255,95003,Albagiara,117,131,248
737357,95004,Ales,698,686,1384
737459,95005,Allai,188,176,364
737561,95006,Arborea,1925,1947,3872
737663,95007,Ardauli,395,450,845
737765,95008,Assolo,189,182,371
737867,95009,Asuni,161,167,328
737969,95010,Baradili,38,44,82
738071,95011,Baratili San Pietro,641,639,1280
738173,95012,Baressa,321,297,618
738275,95013,Bauladu,328,341,669
738377,95014,Bidonì,70,68,138
738479,95015,Bonarcado,792,776,1568
738581,95016,Boroneddu,76,82,158
738683,95017,Busachi,597,659,1256
738785,95018,Cabras,4607,4545,9152
738887,95019,Cuglieri,1284,1297,2581
738989,95020,Fordongianus,426,441,867
739091,95021,Ghilarza,2130,2304,4434
739193,95022,Gonnoscodina,252,208,460
739295,95023,Gonnosnò,371,369,740
739397,95024,Gonnostramatza,417,449,866
739499,95025,Marrubiu,2404,2367,4771
739601,95026,Masullas,546,500,1046
739703,95027,Milis,753,741,1494
739805,95028,Mogorella,228,214,442
739907,95029,Mogoro,2048,2043,4091
740009,95030,Morgongiori,351,345,696
740111,95031,Narbolia,871,899,1770
740213,95032,Neoneli,316,329,645
740315,95033,Norbello,688,584,1272
740417,95034,Nughedu Santa Vittoria,221,248,469
740519,95035,Nurachi,857,903,1760
740621,95036,Nureci,176,171,347
740723,95037,Ollastra,591,606,1197
740825,95038,Oristano,15091,16618,31709
740927,95039,Palmas Arborea,767,763,1530
741029,95040,Pau,138,157,295
741131,95041,Paulilatino,1102,1087,2189
741233,95042,Pompu,130,119,249
741335,95043,Riola Sardo,1091,1025,2116
741437,95044,Ruinas,323,341,664
741539,95045,Samugheo,1465,1496,2961
741641,95046,San Nicolò d'Arcidano,1309,1287,2596
741743,95047,Santa Giusta,2389,2406,4795
741845,95048,Villa Sant'Antonio,171,176,347
741947,95049,Santu Lussurgiu,1163,1177,2340
742049,95050,San Vero Milis,1252,1207,2459
742151,95051,Scano di Montiferro,714,768,1482
742253,95052,Sedilo,1015,1050,2065
742355,95053,Seneghe,864,880,1744
742457,95054,Senis,209,234,443
742559,95055,Sennariolo,78,102,180
742661,95056,Siamaggiore,460,447,907
742763,95057,Siamanna,408,389,797
742865,95058,Simala,166,145,311
742967,95059,Simaxis,1102,1102,2204
743069,95060,Sini,271,230,501
743171,95061,Siris,123,105,228
743273,95062,Solarussa,1171,1199,2370
743375,95063,Sorradile,170,190,360
743477,95064,Tadasuni,70,72,142
743579,95065,Terralba,5102,5049,10151
743681,95066,Tramatza,487,477,964
743783,95067,Tresnuraghes,538,579,1117
743885,95068,Ulà Tirso,248,267,515
743987,95069,Uras,1390,1415,2805
744089,95070,Usellus,382,370,752
744191,95071,Villanova Truschedu,139,165,304
744293,95072,Villaurbana,782,817,1599
744395,95073,Villa Verde,147,162,309
744497,95074,Zeddiani,590,574,1164
744599,95075,Zerfaliu,504,548,1052
744701,95076,Siapiccia,181,167,348
744803,95077,Curcuris,144,154,298
744905,95078,Soddì,53,67,120
745007,95079,Bosa,3815,4037,7852
745109,95080,Flussio,203,233,436
745211,95082,Laconi,895,907,1802
745313,95083,Magomadas,319,320,639
745415,95084,Modolo,70,86,156
745517,95085,Montresta,231,228,459
745619,95086,Sagama,99,99,198
745721,95087,Suni,485,567,1052
745823,95088,Tinnura,121,120,241
745925,96001,Ailoche,147,180,327
746027,96002,Andorno Micca,1531,1644,3175
746129,96003,Benna,568,604,1172
746231,96004,Biella,20573,23414,43987
746333,96005,Bioglio,452,434,886
746435,96006,Borriana,405,470,875
746537,96007,Brusnengo,965,1054,2019
746639,96008,Callabiana,72,61,133
746741,96009,Camandona,172,176,348
746843,96010,Camburzano,546,608,1154
746945,96012,Candelo,3591,3930,7521
747047,96013,Caprile,99,91,190
747149,96014,Casapinta,185,234,419
747251,96015,Castelletto Cervo,418,402,820
747353,96016,Cavaglià,1825,1801,3626
747455,96018,Cerrione,1392,1489,2881
747557,96019,Coggiola,865,936,1801
747659,96020,Cossato,6864,7670,14534
747761,96021,Crevacuore,720,778,1498
747863,96023,Curino,233,248,481
747965,96024,Donato,364,356,720
748067,96025,Dorzano,274,257,531
748169,96026,Gaglianico,1734,2004,3738
748271,96027,Gifflenga,60,53,113
748373,96028,Graglia,752,762,1514
748475,96030,Magnano,208,186,394
748577,96031,Massazza,269,288,557
748679,96032,Masserano,1028,1066,2094
748781,96033,Mezzana Mortigliengo,242,259,501
748883,96034,Miagliano,267,304,571
748985,96035,Mongrando,1810,1984,3794
749087,96037,Mottalciata,683,671,1354
749189,96038,Muzzano,289,312,601
749291,96039,Netro,488,484,972
749393,96040,Occhieppo Inferiore,1841,2061,3902
749495,96041,Occhieppo Superiore,1278,1413,2691
749597,96042,Pettinengo,764,756,1520
749699,96043,Piatto,243,261,504
749801,96044,Piedicavallo,95,83,178
749903,96046,Pollone,1057,1055,2112
750005,96047,Ponderano,1864,1920,3784
750107,96048,Portula,581,611,1192
750209,96049,Pralungo,1155,1215,2370
750311,96050,Pray,1006,1107,2113
750413,96053,Ronco Biellese,767,742,1509
750515,96054,Roppolo,413,467,880
750617,96055,Rosazza,41,50,91
750719,96056,Sagliano Micca,777,828,1605
750821,96057,Sala Biellese,295,297,592
750923,96058,Salussola,975,949,1924
751025,96059,Sandigliano,1300,1369,2669
751127,96063,Sordevolo,648,694,1342
751229,96064,Sostegno,367,402,769
751331,96065,Strona,532,538,1070
751433,96066,Tavigliano,465,462,927
751535,96067,Ternengo,136,144,280
751637,96068,Tollegno,1193,1254,2447
751739,96069,Torrazzo,101,103,204
751841,96071,Valdengo,1183,1278,2461
751943,96072,Vallanzengo,111,105,216
752045,96074,Valle San Nicolao,483,468,951
752147,96075,Veglio,242,235,477
752249,96076,Verrone,629,618,1247
752351,96077,Vigliano Biellese,3692,3974,7666
752453,96078,Villa del Bosco,146,189,335
752555,96079,Villanova Biellese,91,94,185
752657,96080,Viverone,680,731,1411
752759,96081,Zimone,199,200,399
752861,96082,Zubiena,574,574,1148
752963,96083,Zumaglia,491,530,1021
753065,96085,Lessona,1319,1405,2724
753167,96086,Campiglia Cervo,247,255,502
753269,96087,Quaregna Cerreto,997,1044,2041
753371,96088,Valdilana,5228,5597,10825
753473,97001,Abbadia Lariana,1559,1646,3205
753575,97002,Airuno,1439,1417,2856
753677,97003,Annone di Brianza,1139,1164,2303
753779,97004,Ballabio,2062,1987,4049
753881,97005,Barzago,1193,1206,2399
753983,97006,Barzanò,2509,2572,5081
754085,97007,Barzio,631,675,1306
754187,97008,Bellano,1572,1613,3185
754289,97009,Bosisio Parini,1688,1719,3407
754391,97010,Brivio,2313,2281,4594
754493,97011,Bulciago,1484,1448,2932
754595,97012,Calco,2704,2709,5413
754697,97013,Calolziocorte,6757,7110,13867
754799,97014,Carenno,729,723,1452
754901,97015,Casargo,410,419,829
755003,97016,Casatenovo,6387,6724,13111
755105,97017,Cassago Brianza,2205,2165,4370
755207,97018,Cassina Valsassina,261,254,515
755309,97019,Castello di Brianza,1332,1266,2598
755411,97020,Cernusco Lombardone,1892,1977,3869
755513,97021,Cesana Brianza,1186,1193,2379
755615,97022,Civate,1873,1928,3801
755717,97023,Colico,3926,3995,7921
755819,97024,Colle Brianza,890,850,1740
755921,97025,Cortenova,588,579,1167
756023,97026,Costa Masnaga,2405,2377,4782
756125,97027,Crandola Valsassina,133,124,257
756227,97028,Cremella,850,861,1711
756329,97029,Cremeno,852,775,1627
756431,97030,Dervio,1268,1324,2592
756533,97031,Dolzago,1269,1280,2549
756635,97032,Dorio,156,160,316
756737,97033,Ello,571,648,1219
756839,97034,Erve,345,359,704
756941,97035,Esino Lario,386,380,766
757043,97036,Galbiate,4174,4339,8513
757145,97037,Garbagnate Monastero,1292,1229,2521
757247,97038,Garlate,1358,1364,2722
757349,97039,Imbersago,1256,1229,2485
757451,97040,Introbio,999,994,1993
757553,97042,Lecco,23284,25049,48333
757655,97043,Lierna,1063,1052,2115
757757,97044,Lomagna,2506,2562,5068
757859,97045,Malgrate,2150,2223,4373
757961,97046,Mandello del Lario,5021,5235,10256
758063,97047,Margno,186,181,367
758165,97048,Merate,7143,7748,14891
758267,97049,Missaglia,4341,4371,8712
758369,97050,Moggio,246,245,491
758471,97051,Molteno,1824,1769,3593
758573,97052,Monte Marenzo,947,941,1888
758675,97053,Montevecchia,1348,1351,2699
758777,97054,Monticello Brianza,2043,2131,4174
758879,97055,Morterone,18,15,33
758981,97056,Nibionno,1843,1859,3702
759083,97057,Oggiono,4512,4640,9152
759185,97058,Olgiate Molgora,3203,3306,6509
759287,97059,Olginate,3474,3565,7039
759389,97060,Oliveto Lario,624,595,1219
759491,97061,Osnago,2329,2421,4750
759593,97062,Paderno d'Adda,1873,1932,3805
759695,97063,Pagnona,176,175,351
759797,97064,Parlasco,69,65,134
759899,97065,Pasturo,1002,984,1986
760001,97067,Perledo,447,467,914
760103,97068,Pescate,1116,1105,2221
760205,97069,Premana,1129,1100,2229
760307,97070,Primaluna,1116,1147,2263
760409,97071,Robbiate,3164,3222,6386
760511,97072,Rogeno,1594,1533,3127
760613,97074,Santa Maria Hoè,1107,1062,2169
760715,97075,Sirone,1137,1172,2309
760817,97076,Sirtori,1415,1409,2824
760919,97077,Sueglio,72,90,162
761021,97078,Suello,867,893,1760
761123,97079,Taceno,278,256,534
761225,97082,Valgreghentino,1711,1717,3428
761327,97083,Valmadrera,5640,5851,11491
761429,97084,Varenna,364,365,729
761531,97085,Vendrogno,143,153,296
761633,97086,Vercurago,1334,1487,2821
761735,97090,Viganò,1046,1043,2089
761837,97091,Verderio,2800,2819,5619
761939,97092,La Valletta Brianza,2349,2367,4716
762041,97093,Valvarrone,270,277,547
762143,98001,Abbadia Cerreto,140,137,277
762245,98002,Bertonico,570,548,1118
762347,98003,Boffalora d'Adda,931,839,1770
762449,98004,Borghetto Lodigiano,2145,2166,4311
762551,98005,Borgo San Giovanni,1223,1214,2437
762653,98006,Brembio,1364,1356,2720
762755,98008,Casaletto Lodigiano,1460,1470,2930
762857,98009,Casalmaiocco,1552,1593,3145
762959,98010,Casalpusterlengo,7539,7754,15293
763061,98011,Caselle Landi,764,782,1546
763163,98012,Caselle Lurani,1533,1451,2984
763265,98013,Castelnuovo Bocca d'Adda,798,805,1603
763367,98014,Castiglione d'Adda,2329,2317,4646
763469,98015,Castiraga Vidardo,1463,1410,2873
763571,98017,Cavenago d'Adda,1078,1086,2164
763673,98018,Cervignano d'Adda,1092,1097,2189
763775,98019,Codogno,7717,8274,15991
763877,98020,Comazzo,1204,1140,2344
763979,98021,Cornegliano Laudense,1438,1475,2913
764081,98022,Corno Giovine,548,581,1129
764183,98023,Cornovecchio,116,97,213
764285,98024,Corte Palasio,780,736,1516
764387,98025,Crespiatica,1187,1111,2298
764489,98026,Fombio,1177,1140,2317
764591,98027,Galgagnano,645,638,1283
764693,98028,Graffignana,1307,1319,2626
764795,98029,Guardamiglio,1360,1302,2662
764897,98030,Livraga,1258,1272,2530
764999,98031,Lodi,22032,23840,45872
765101,98032,Lodi Vecchio,3728,3881,7609
765203,98033,Maccastorna,40,26,66
765305,98034,Mairago,697,688,1385
765407,98035,Maleo,1506,1592,3098
765509,98036,Marudo,886,832,1718
765611,98037,Massalengo,2315,2235,4550
765713,98038,Meleti,223,229,452
765815,98039,Merlino,907,822,1729
765917,98040,Montanaso Lombardo,1110,1154,2264
766019,98041,Mulazzano,2905,2893,5798
766121,98042,Orio Litta,995,1032,2027
766223,98043,Ospedaletto Lodigiano,875,831,1706
766325,98044,Ossago Lodigiano,721,712,1433
766427,98045,Pieve Fissiraga,883,886,1769
766529,98046,Salerano sul Lambro,1277,1367,2644
766631,98047,San Fiorano,921,918,1839
766733,98048,San Martino in Strada,1895,1860,3755
766835,98049,San Rocco al Porto,1668,1760,3428
766937,98050,Sant'Angelo Lodigiano,6510,6735,13245
767039,98051,Santo Stefano Lodigiano,949,961,1910
767141,98052,Secugnago,956,1000,1956
767243,98053,Senna Lodigiana,930,916,1846
767345,98054,Somaglia,1892,1944,3836
767447,98055,Sordio,1722,1707,3429
767549,98056,Tavazzano con Villavesco,2947,3087,6034
767651,98057,Terranova dei Passerini,471,456,927
767753,98058,Turano Lodigiano,760,783,1543
767855,98059,Valera Fratta,856,852,1708
767957,98060,Villanova del Sillaro,956,894,1850
768059,98061,Zelo Buon Persico,3659,3787,7446
768161,98062,Castelgerundo,753,745,1498
768263,99001,Bellaria-Igea Marina,9526,10043,19569
768365,99002,Cattolica,8083,9060,17143
768467,99003,Coriano,5221,5374,10595
768569,99004,Gemmano,589,557,1146
768671,99005,Misano Adriatico,6582,6818,13400
768773,99006,Mondaino,668,699,1367
768875,99008,Montefiore Conca,1102,1131,2233
768977,99009,Montegridolfo,505,506,1011
769079,99011,Morciano di Romagna,3456,3672,7128
769181,99013,Riccione,16523,18658,35181
769283,99014,Rimini,72269,78307,150576
769385,99015,Saludecio,1566,1493,3059
769487,99016,San Clemente,2790,2813,5603
769589,99017,San Giovanni in Marignano,4575,4877,9452
769691,99018,Santarcangelo di Romagna,10752,11543,22295
769793,99020,Verucchio,5044,4992,10036
769895,99021,Casteldelci,188,196,384
769997,99022,Maiolo,421,389,810
770099,99023,Novafeltria,3532,3604,7136
770201,99024,Pennabilli,1362,1405,2767
770303,99025,San Leo,1433,1469,2902
770405,99026,Sant'Agata Feltria,1069,1018,2087
770507,99027,Talamello,518,566,1084
770609,99028,Poggio Torriana,2599,2628,5227
770711,99029,Montescudo-Monte Colombo,3440,3386,6826
770813,100001,Cantagallo,1574,1532,3106
770915,100002,Carmignano,7376,7459,14835
771017,100003,Montemurlo,9272,9549,18821
771119,100004,Poggio a Caiano,4930,5213,10143
771221,100005,Prato,94418,100172,194590
771323,100006,Vaiano,4970,5167,10137
771425,100007,Vernio,2996,3088,6084
771527,101001,Belvedere di Spinello,1095,1150,2245
771629,101002,Caccuri,780,827,1607
771731,101003,Carfizzi,286,304,590
771833,101004,Casabona,1212,1336,2548
771935,101005,Castelsilano,482,480,962
772037,101006,Cerenzia,549,564,1113
772139,101007,Cirò,1296,1439,2735
772241,101008,Cirò Marina,7169,7546,14715
772343,101009,Cotronei,2645,2797,5442
772445,101010,Crotone,33625,31085,64710
772547,101011,Crucoli,1438,1555,2993
772649,101012,Cutro,5212,5198,10410
772751,101013,Isola di Capo Rizzuto,9439,8409,17848
772853,101014,Melissa,1726,1756,3482
772955,101015,Mesoraca,3055,3222,6277
773057,101016,Pallagorio,543,583,1126
773159,101017,Petilia Policastro,4520,4515,9035
773261,101018,Roccabernarda,1656,1676,3332
773363,101019,Rocca di Neto,2798,2840,5638
773465,101020,San Mauro Marchesato,1011,1058,2069
773567,101021,San Nicola dell'Alto,365,409,774
773669,101022,Santa Severina,996,1033,2029
773771,101023,Savelli,588,599,1187
773873,101024,Scandale,1506,1588,3094
773975,101025,Strongoli,3159,3299,6458
774077,101026,Umbriatico,407,403,810
774179,101027,Verzino,839,912,1751
774281,102001,Acquaro,1117,1165,2282
774383,102002,Arena,692,729,1421
774485,102003,Briatico,2415,1943,4358
774587,102004,Brognaturo,449,335,784
774689,102005,Capistrano,486,506,992
774791,102006,Cessaniti,1640,1596,3236
774893,102007,Dasà,560,594,1154
774995,102008,Dinami,994,1016,2010
775097,102009,Drapia,993,1054,2047
775199,102010,Fabrizia,1024,1093,2117
775301,102011,Filadelfia,2583,2626,5209
775403,102012,Filandari,898,947,1845
775505,102013,Filogaso,722,682,1404
775607,102014,Francavilla Angitola,960,965,1925
775709,102015,Francica,833,827,1660
775811,102016,Gerocarne,1059,1052,2111
775913,102017,Ionadi,2170,2234,4404
776015,102018,Joppolo,963,950,1913
776117,102019,Limbadi,1762,1794,3556
776219,102020,Maierato,1038,1100,2138
776321,102021,Mileto,3352,3349,6701
776423,102022,Mongiana,362,350,712
776525,102023,Monterosso Calabro,827,840,1667
776627,102024,Nardodipace,630,613,1243
776729,102025,Nicotera,3172,3036,6208
776831,102026,Parghelia,630,658,1288
776933,102027,Pizzo,4533,4745,9278
777035,102028,Pizzoni,508,554,1062
777137,102029,Polia,461,481,942
777239,102030,Ricadi,2484,2492,4976
777341,102031,Rombiolo,2244,2245,4489
777443,102032,San Calogero,2060,2068,4128
777545,102033,San Costantino Calabro,1062,1124,2186
777647,102034,San Gregorio d'Ippona,1339,1302,2641
777749,102035,San Nicola da Crissa,641,656,1297
777851,102036,Sant'Onofrio,1505,1530,3035
777953,102037,Serra San Bruno,3314,3270,6584
778055,102038,Simbario,461,478,939
778157,102039,Sorianello,587,565,1152
778259,102040,Soriano Calabro,1177,1201,2378
778361,102041,Spadola,405,394,799
778463,102042,Spilinga,714,744,1458
778565,102043,Stefanaconi,1210,1214,2424
778667,102044,Tropea,2999,3270,6269
778769,102045,Vallelonga,391,374,765
778871,102046,Vazzano,482,530,1012
778973,102047,Vibo Valentia,16253,17202,33455
779075,102048,Zaccanopoli,348,371,719
779177,102049,Zambrone,871,892,1763
779279,102050,Zungri,970,967,1937
779381,103001,Antrona Schieranco,207,212,419
779483,103002,Anzola d'Ossola,210,197,407
779585,103003,Arizzano,981,1031,2012
779687,103004,Arola,121,122,243
779789,103005,Aurano,56,47,103
779891,103006,Baceno,425,472,897
779993,103007,Bannio Anzino,246,232,478
780095,103008,Baveno,2415,2504,4919
780197,103009,Bee,355,400,755
780299,103010,Belgirate,240,263,503
780401,103011,Beura-Cardezza,746,722,1468
780503,103012,Bognanco,101,87,188
780605,103013,Brovello-Carpugnino,357,354,711
780707,103014,Calasca-Castiglione,322,289,611
780809,103015,Cambiasca,785,838,1623
780911,103016,Cannero Riviera,444,466,910
781013,103017,Cannobio,2427,2693,5120
781115,103018,Caprezzo,92,77,169
781217,103019,Casale Corte Cerro,1708,1758,3466
781319,103021,Ceppo Morelli,154,143,297
781421,103022,Cesara,300,294,594
781523,103023,Cossogno,354,325,679
781625,103024,Craveggia,408,354,762
781727,103025,Crevoladossola,2245,2355,4600
781829,103026,Crodo,696,702,1398
781931,103028,Domodossola,8659,9487,18146
782033,103029,Druogno,518,546,1064
782135,103031,Formazza,224,218,442
782237,103032,Germagno,105,85,190
782339,103033,Ghiffa,1156,1198,2354
782441,103034,Gignese,533,515,1048
782543,103035,Gravellona Toce,3783,4025,7808
782645,103036,Gurro,97,102,199
782747,103037,Intragna,56,52,108
782849,103038,Loreglia,117,116,233
782951,103039,Macugnaga,281,261,542
783053,103040,Madonna del Sasso,228,177,405
783155,103041,Malesco,674,705,1379
783257,103042,Masera,717,761,1478
783359,103043,Massiola,65,61,126
783461,103044,Mergozzo,1067,1098,2165
783563,103045,Miazzina,208,174,382
783665,103046,Montecrestese,626,646,1272
783767,103047,Montescheno,191,201,392
783869,103048,Nonio,414,447,861
783971,103049,Oggebbio,414,459,873
784073,103050,Omegna,7411,7779,15190
784175,103051,Ornavasso,1690,1745,3435
784277,103052,Pallanzeno,574,574,1148
784379,103053,Piedimulera,748,773,1521
784481,103054,Pieve Vergonte,1216,1302,2518
784583,103055,Premeno,363,367,730
784685,103056,Premia,280,273,553
784787,103057,Premosello-Chiovenda,926,1015,1941
784889,103058,Quarna Sopra,118,134,252
784991,103059,Quarna Sotto,195,190,385
785093,103060,Re,355,381,736
785195,103061,San Bernardino Verbano,659,659,1318
785297,103062,Santa Maria Maggiore,633,659,1292
785399,103064,Stresa,2339,2531,4870
785501,103065,Toceno,374,355,729
785603,103066,Trarego Viggiona,204,213,417
785705,103067,Trasquera,83,92,175
785807,103068,Trontano,821,848,1669
785909,103069,Valstrona,619,597,1216
786011,103070,Vanzone con San Carlo,187,195,382
786113,103071,Varzo,980,1037,2017
786215,103072,Verbania,14372,16133,30505
786317,103074,Vignone,585,610,1195
786419,103075,Villadossola,3134,3388,6522
786521,103076,Villette,137,141,278
786623,103077,Vogogna,887,869,1756
786725,103078,Borgomezzavalle,154,161,315
786827,103079,Valle Cannobina,248,237,485
786929,108001,Agrate Brianza,7674,7924,15598
787031,108002,Aicurzio,1042,1054,2096
787133,108003,Albiate,3104,3271,6375
787235,108004,Arcore,8707,9226,17933
787337,108005,Barlassina,3450,3569,7019
787439,108006,Bellusco,3640,3775,7415
787541,108007,Bernareggio,5687,5522,11209
787643,108008,Besana in Brianza,7656,7876,15532
787745,108009,Biassono,5912,6338,12250
787847,108010,Bovisio-Masciago,8284,8649,16933
787949,108011,Briosco,3044,3034,6078
788051,108012,Brugherio,17027,18037,35064
788153,108013,Burago di Molgora,2042,2204,4246
788255,108014,Camparada,1105,1051,2156
788357,108015,Carate Brianza,8779,9166,17945
788459,108016,Carnate,3642,3694,7336
788561,108017,Cavenago di Brianza,3667,3694,7361
788663,108018,Ceriano Laghetto,3255,3317,6572
788765,108019,Cesano Maderno,19506,19644,39150
788867,108020,Cogliate,4197,4333,8530
788969,108021,Concorezzo,7643,8063,15706
789071,108022,Correzzana,1523,1510,3033
789173,108023,Desio,20624,21318,41942
789275,108024,Giussano,12962,13104,26066
789377,108025,Lazzate,3845,3924,7769
789479,108026,Lesmo,4264,4271,8535
789581,108027,Limbiate,17375,17678,35053
789683,108028,Lissone,22524,23493,46017
789785,108029,Macherio,3690,3819,7509
789887,108030,Meda,11491,12011,23502
789989,108031,Mezzago,2267,2232,4499
790091,108032,Misinto,2819,2778,5597
790193,108033,Monza,59252,64145,123397
790295,108034,Muggiò,11535,12001,23536
790397,108035,Nova Milanese,11555,11959,23514
790499,108036,Ornago,2518,2591,5109
790601,108037,Renate,2006,2026,4032
790703,108038,Ronco Briantino,1731,1772,3503
790805,108039,Seregno,21735,23250,44985
790907,108040,Seveso,11664,12067,23731
791009,108041,Sovico,4096,4250,8346
791111,108042,Sulbiate,2185,2149,4334
791213,108043,Triuggio,4407,4390,8797
791315,108044,Usmate Velate,5089,5236,10325
791417,108045,Varedo,6641,6955,13596
791519,108046,Vedano al Lambro,3649,3929,7578
791621,108047,Veduggio con Colzano,2191,2129,4320
791723,108048,Verano Brianza,4572,4708,9280
791825,108049,Villasanta,6789,7203,13992
791927,108050,Vimercate,12582,13532,26114
792029,108051,Busnago,3371,3414,6785
792131,108052,Caponago,2554,2625,5179
792233,108053,Cornate d'Adda,5391,5408,10799
792335,108054,Lentate sul Seveso,7921,7981,15902
792437,108055,Roncello,2384,2371,4755
792539,109001,Altidona,1712,1789,3501
792641,109002,Amandola,1714,1799,3513
792743,109003,Belmonte Piceno,302,324,626
792845,109004,Campofilone,960,952,1912
792947,109005,Falerone,1645,1640,3285
793049,109006,Fermo,17944,19175,37119
793151,109007,Francavilla d'Ete,468,466,934
793253,109008,Grottazzolina,1579,1742,3321
793355,109009,Lapedona,582,594,1176
793457,109010,Magliano di Tenna,712,718,1430
793559,109011,Massa Fermana,448,489,937
793661,109012,Monsampietro Morico,318,316,634
793763,109013,Montappone,795,873,1668
793865,109014,Montefalcone Appennino,201,206,407
793967,109015,Montefortino,561,562,1123
794069,109016,Monte Giberto,388,387,775
794171,109017,Montegiorgio,3269,3433,6702
794273,109018,Montegranaro,6412,6500,12912
794375,109019,Monteleone di Fermo,201,169,370
794477,109020,Montelparo,378,371,749
794579,109021,Monte Rinaldo,180,172,352
794681,109022,Monterubbiano,1043,1124,2167
794783,109023,Monte San Pietrangeli,1153,1226,2379
794885,109024,Monte Urano,4040,4078,8118
794987,109025,Monte Vidon Combatte,194,232,426
795089,109026,Monte Vidon Corrado,338,356,694
795191,109027,Montottone,440,490,930
795293,109028,Moresco,272,287,559
795395,109029,Ortezzano,378,380,758
795497,109030,Pedaso,1374,1480,2854
795599,109031,Petritoli,1111,1169,2280
795701,109032,Ponzano di Fermo,838,829,1667
795803,109033,Porto San Giorgio,7565,8514,16079
795905,109034,Porto Sant'Elpidio,12824,13515,26339
796007,109035,Rapagnano,1003,1018,2021
796109,109036,Santa Vittoria in Matenano,637,673,1310
796211,109037,Sant'Elpidio a Mare,8511,8655,17166
796313,109038,Servigliano,1134,1136,2270
796415,109039,Smerillo,181,171,352
796517,109040,Torre San Patrizio,984,1001,1985
796619,110001,Andria,49266,50405,99671
796721,110002,Barletta,46871,47693,94564
796823,110003,Bisceglie,27423,27828,55251
796925,110004,Canosa di Puglia,14595,15062,29657
797027,110005,Margherita di Savoia,5724,5984,11708
797129,110006,Minervino Murge,4301,4418,8719
797231,110007,San Ferdinando di Puglia,6828,6886,13714
797333,110008,Spinazzola,3044,3321,6365
797435,110009,Trani,27652,28199,55851
797537,110010,Trinitapoli,7068,7443,14511
797639,111001,Arbus,3061,3128,6189
797741,111002,Armungia,232,229,461
797843,111003,Ballao,393,378,771
797945,111004,Barrali,570,553,1123
798047,111005,Barumini,611,629,1240
798149,111006,Buggerru,524,529,1053
798251,111007,Burcei,1387,1366,2753
798353,111008,Calasetta,1453,1433,2886
798455,111009,Carbonia,13324,14685,28009
798557,111010,Carloforte,3036,3115,6151
798659,111011,Castiadas,852,801,1653
798761,111012,Collinas,400,412,812
798863,111013,Decimoputzu,2202,2145,4347
798965,111014,Dolianova,4863,4773,9636
799067,111015,Domus de Maria,852,804,1656
799169,111016,Domusnovas,3002,3083,6085
799271,111017,Donori,1026,1031,2057
799373,111018,Escalaplano,1134,1012,2146
799475,111019,Escolca,276,300,576
799577,111020,Esterzili,289,320,609
799679,111021,Fluminimaggiore,1503,1435,2938
799781,111022,Furtei,801,796,1597
799883,111023,Genoni,404,402,806
799985,111024,Genuri,147,164,311
800087,111025,Gergei,617,584,1201
800189,111026,Gesico,424,411,835
800291,111027,Gesturi,604,607,1211
800393,111028,Giba,993,1024,2017
800495,111029,Goni,253,220,473
800597,111030,Gonnesa,2458,2486,4944
800699,111031,Gonnosfanadiga,3173,3307,6480
800801,111032,Guamaggiore,482,488,970
800903,111033,Guasila,1332,1327,2659
801005,111034,Guspini,5701,5863,11564
801107,111035,Iglesias,12762,13753,26515
801209,111036,Isili,1283,1332,2615
801311,111037,Las Plassas,119,108,227
801413,111038,Lunamatrona,824,855,1679
801515,111039,Mandas,1070,1070,2140
801617,111040,Masainas,621,652,1273
801719,111041,Monastir,2314,2306,4620
801821,111042,Muravera,2591,2681,5272
801923,111043,Musei,804,731,1535
802025,111044,Narcao,1591,1582,3173
802127,111045,Nuragus,424,453,877
802229,111046,Nurallao,634,597,1231
802331,111047,Nuraminis,1233,1247,2480
802433,111048,Nurri,1096,1046,2142
802535,111049,Nuxis,757,792,1549
802637,111050,Orroli,1095,1095,2190
802739,111051,Ortacesus,477,425,902
802841,111052,Pabillonis,1392,1326,2718
802943,111053,Pauli Arbarei,293,297,590
803045,111054,Perdaxius,702,695,1397
803147,111055,Pimentel,612,574,1186
803249,111056,Piscinas,405,445,850
803351,111057,Portoscuso,2484,2570,5054
803453,111058,Sadali,493,447,940
803555,111059,Samassi,2457,2641,5098
803657,111060,Samatzai,809,829,1638
803759,111061,San Basilio,616,602,1218
803861,111062,San Gavino Monreale,4147,4336,8483
803963,111063,San Giovanni Suergiu,3006,2996,6002
804065,111064,San Nicolò Gerrei,385,358,743
804167,111065,San Sperate,4184,4158,8342
804269,111066,San Vito,1795,1828,3623
804371,111067,Sanluri,4169,4288,8457
804473,111068,Santadi,1631,1698,3329
804575,111069,Sant'Andrea Frius,901,839,1740
804677,111070,Sant'Anna Arresi,1384,1345,2729
804779,111071,Sant'Antioco,5508,5575,11083
804881,111072,Sardara,1954,2030,3984
804983,111073,Segariu,579,568,1147
805085,111074,Selegas,659,702,1361
805187,111075,Senorbì,2430,2437,4867
805289,111076,Serdiana,1354,1329,2683
805391,111077,Serramanna,4519,4522,9041
805493,111078,Serrenti,2394,2362,4756
805595,111079,Serri,332,321,653
805697,111080,Setzu,72,67,139
805799,111081,Seui,643,617,1260
805901,111082,Seulo,419,389,808
806003,111083,Siddi,316,321,637
806105,111084,Siliqua,1878,1901,3779
806207,111085,Silius,621,525,1146
806309,111086,Siurgus Donigala,960,995,1955
806411,111087,Soleminis,911,928,1839
806513,111088,Suelli,574,553,1127
806615,111089,Teulada,1817,1684,3501
806717,111090,Tratalias,535,527,1062
806819,111091,Tuili,493,509,1002
806921,111092,Turri,206,214,420
807023,111093,Ussana,2061,2105,4166
807125,111094,Ussaramanna,269,248,517
807227,111095,Vallermosa,998,917,1915
807329,111096,Villacidro,6929,6959,13888
807431,111097,Villamar,1336,1301,2637
807533,111098,Villamassargia,1751,1775,3526
807635,111099,Villanova Tulo,567,511,1078
807737,111100,Villanovaforru,359,295,654
807839,111101,Villanovafranca,658,638,1296
807941,111102,Villaperuccio,543,536,1079
808043,111103,Villaputzu,2302,2363,4665
808145,111104,Villasalto,510,521,1031
808247,111105,Villasimius,1888,1842,3730
808349,111106,Villasor,3470,3450,6920
808451,111107,Villaspeciosa,1308,1289,2597
